ID,Race,Age,Gender,undergrad_gpa,math_camp,gre_verbal,gre_quant,gre_total,graduate_gpa
232,White,23,Female,2.55,FALSE,157,148,305,3.36
100,Other,21,Trans*,1.96,FALSE,139,134,273,2.99
419,Hispanic,21,Male,2.41,FALSE,137,132,269,3.13
692,Asian,21,Male,2.14,FALSE,142,140,282,2.54
1720,Hispanic,29,Female,1.01,FALSE,155,142,297,3.18
283,Black,24,Male,3.01,TRUE,159,132,291,3.39
525,White,22,Female,2.47,FALSE,152,133,285,3.13
466,White,28,Male,2.24,TRUE,144,134,278,3.7
701,Asian,28,Female,3,FALSE,143,136,279,3.07
1908,White,26,Trans*,1.89,FALSE,164,157,321,3.73
0672,White,30,Female,1.97,FALSE,156,155,311,2.81
0869,Hispanic,26,Trans*,1.05,FALSE,132,147,279,3.68
1027,Native,28,Female,2.04,FALSE,159,164,323,3.37
1536,Hispanic,24,Female,2.98,FALSE,155,162,317,2.99
722,White,26,Male,2.38,TRUE,144,142,286,3.65
1905,White,24,Trans*,3.34,FALSE,134,161,295,2.81
0332,White,29,Female,1.06,FALSE,140,164,304,3.46
769,Black,24,Male,2.06,FALSE,159,135,294,2.61
1000,Hispanic,23,Male,3.79,FALSE,161,160,321,3.51
0108,Hispanic,30,Trans*,1.06,FALSE,134,142,276,2.48
0098,Asian,23,Trans*,3.49,FALSE,160,158,318,3.88
364,White,27,Female,2.44,FALSE,142,140,282,3.33
175,White,20,Trans*,2.21,FALSE,135,132,267,2.19
0435,Black,23,Female,2.93,FALSE,142,167,309,2.63
1330,White,21,Trans*,1.67,FALSE,138,163,301,3.37
244,Hispanic,29,Trans*,1.92,TRUE,138,141,279,2.63
0602,White,29,Female,1.65,FALSE,152,158,310,3.47
0718,White,21,Male,3.57,FALSE,155,167,322,3.77
0828,White,26,Male,2.64,FALSE,145,155,300,2.58
1179,White,20,Trans*,3.52,FALSE,141,169,310,3.67
550,Black,27,Female,1.97,TRUE,157,156,313,3.61
1661,Hispanic,24,Female,2.96,FALSE,137,140,277,3.52
0010,Black,27,Male,1.68,FALSE,142,149,291,1.95
034,White,22,Female,2.11,FALSE,131,140,271,3.75
778,White,20,Trans*,2.48,TRUE,148,133,281,2.49
635,Black,25,Male,1.89,FALSE,130,135,265,2.82
1518,White,27,Male,3.47,FALSE,144,133,277,2.91
198,White,25,Female,2.66,FALSE,151,134,285,3.4
271,White,30,Female,3.24,TRUE,137,133,270,3.39
0320,Black,30,Male,2.9,FALSE,132,164,296,2.23
170,White,21,Female,2.28,FALSE,143,134,277,2.52
314,Hispanic,24,Male,2.47,FALSE,161,132,293,2.74
1252,White,22,Trans*,3.01,FALSE,141,163,304,1.84
240,Native,22,Male,2.47,TRUE,143,137,280,2.92
653,Hispanic,30,Female,2.48,FALSE,146,131,277,2.98
473,Asian,20,Male,2.28,FALSE,143,133,276,3.19
0224,White,21,Male,3.56,FALSE,156,133,289,3.75
1066,Black,20,Trans*,2.13,FALSE,153,142,295,3.18
776,White,30,Trans*,1.55,FALSE,143,139,282,2.3
169,Hispanic,25,Male,1.7,FALSE,165,138,303,3.27
0412,Black,29,Female,3.09,FALSE,151,159,310,2.56
1775,Hispanic,29,Male,1.64,FALSE,162,163,325,2.16
0466,Black,29,Trans*,2.83,FALSE,143,143,286,3.99
0868,White,24,Male,2.15,FALSE,154,141,295,2.96
0410,White,30,Female,3.15,FALSE,163,143,306,2.47
0342,White,22,Male,3.69,FALSE,151,160,311,2.98
0305,White,27,Female,2.64,FALSE,161,157,318,1.97
0600,Black,22,Male,2.85,FALSE,148,161,309,3.03
1331,White,22,Male,3.7,FALSE,142,154,296,3.39
737,White,25,Male,2.67,TRUE,147,135,282,2.72
0875,Asian,24,Male,3.2,FALSE,153,143,296,2.89
148,White,30,Male,3.09,FALSE,150,133,283,2.56
1705,White,20,Female,3.25,FALSE,133,156,289,3.08
0616,Hispanic,29,Female,1.25,FALSE,143,146,289,3.3
0903,Black,26,Female,1.36,FALSE,158,149,307,2.87
0519,Hispanic,23,Male,3.02,FALSE,142,135,277,3.71
250,Hispanic,30,Trans*,2.09,TRUE,133,131,264,3.13
1958,White,30,Trans*,3.91,FALSE,135,154,289,2.83
1702,Asian,26,Trans*,1.37,FALSE,138,150,288,2.88
472,Black,22,Trans*,1.79,FALSE,150,134,284,2.61
483,Hispanic,26,Female,2.57,TRUE,143,130,273,3.96
622,White,30,Trans*,2.39,TRUE,153,134,287,3.42
0238,White,23,Female,2.43,FALSE,134,134,268,3.59
482,Black,27,Male,1.49,FALSE,144,142,286,3.33
587,White,24,Female,2.29,TRUE,161,135,296,3.9
625,White,29,Male,3.47,TRUE,151,140,291,3.68
0883,Bi-Racial,20,Female,2.53,FALSE,137,155,292,3.81
162,White,20,Male,2.62,TRUE,133,135,268,3.82
141,White,30,Male,1.66,TRUE,152,144,296,3.33
0957,White,26,Male,2.84,FALSE,141,152,293,1.31
0664,Black,24,Trans*,2.69,FALSE,152,148,300,3.52
450,Asian,22,Male,1.96,FALSE,157,137,294,3.02
022,White,20,Female,2.61,FALSE,140,148,288,3.49
263,Black,20,Male,1.9,FALSE,156,138,294,2.54
1313,White,27,Trans*,1.85,FALSE,164,149,313,3.02
1704,White,30,Male,2.17,FALSE,154,153,307,3.01
298,White,20,Female,2.87,TRUE,151,139,290,3.43
578,White,20,Female,2.45,FALSE,160,132,292,3.94
0677,Asian,26,Trans*,2.26,FALSE,168,141,309,2.4
121,Hispanic,23,Trans*,2.28,TRUE,138,132,270,3.29
345,White,23,Female,2.81,FALSE,155,140,295,2.71
1691,White,22,Male,1.17,FALSE,134,163,297,2.38
0163,White,20,Male,2.9,FALSE,131,169,300,2.64
0702,White,21,Male,2.74,FALSE,167,168,335,3.41
1170,Hispanic,22,Female,3.23,FALSE,166,159,325,3.35
1111,White,26,Female,3.57,FALSE,140,138,278,1.85
1916,White,23,Male,3.95,FALSE,143,147,290,2.65
551,White,23,Male,2.4,TRUE,149,132,281,3.2
0501,Black,28,Female,2.98,FALSE,136,146,282,3.1
476,Bi-Racial,27,Female,1.56,TRUE,137,138,275,3.7
495,Hispanic,23,Male,2.34,FALSE,164,133,297,3.31
0199,White,27,Trans*,1.08,FALSE,146,161,307,3.61
0597,Native,27,Male,1.72,FALSE,144,162,306,3.7
758,Black,25,Trans*,2.52,TRUE,160,141,301,3.02
527,White,23,Female,1.69,FALSE,150,139,289,2.78
703,Hispanic,26,Trans*,1.52,TRUE,148,134,282,3.43
759,White,27,Trans*,3.41,TRUE,156,134,290,3.33
039,Black,28,Female,2.61,FALSE,166,131,297,3.39
1446,White,24,Male,2.86,FALSE,151,140,291,3.8
383,White,25,Male,3.39,FALSE,152,143,295,2.65
1116,White,29,Trans*,2.88,FALSE,155,157,312,3.56
0857,White,27,Trans*,1.39,FALSE,144,138,282,3.58
1409,White,20,Female,3.67,FALSE,134,163,297,3.19
183,White,27,Trans*,2.14,FALSE,155,131,286,2.12
1007,White,25,Female,3.83,FALSE,167,158,325,3.36
1300,White,26,Trans*,2.04,FALSE,146,148,294,3.2
1278,Other,24,Trans*,3.65,FALSE,160,161,321,3.36
781,White,23,Male,2.87,FALSE,133,141,274,2.64
443,Hispanic,25,Trans*,2.27,TRUE,156,138,294,3.05
0768,Black,28,Female,2.35,FALSE,153,145,298,3.74
1102,White,25,Female,2.36,FALSE,152,140,292,2.38
1450,Asian,22,Trans*,1.65,FALSE,142,155,297,2.65
457,White,22,Male,2.8,FALSE,138,140,278,1.84
188,White,29,Female,2.64,FALSE,133,132,265,2.49
411,White,23,Trans*,2.07,FALSE,161,134,295,3.13
273,White,27,Male,1.62,TRUE,159,135,294,3.02
1009,White,28,Female,2.08,FALSE,139,135,274,2.89
396,Black,20,Male,3.61,TRUE,169,133,302,3.3
0232,White,30,Male,3.75,FALSE,165,163,328,3.97
774,White,25,Male,2.56,TRUE,162,145,307,2.78
0882,White,27,Male,3.03,FALSE,160,158,318,2.73
1599,White,21,Trans*,3.5,FALSE,149,151,300,2.27
298,Black,23,Trans*,3.09,FALSE,157,130,287,2.56
0123,White,20,Female,1.89,FALSE,148,169,317,2.3
089,White,25,Female,2.06,TRUE,135,132,267,2.37
0689,White,28,Male,2.5,FALSE,147,148,295,3.47
0666,White,24,Male,1.27,FALSE,145,138,283,3.54
402,White,23,Female,3.7,TRUE,164,137,301,3.07
352,White,24,Trans*,3.68,FALSE,142,138,280,2.65
0537,White,20,Female,3.11,FALSE,154,160,314,3.78
465,Hispanic,30,Male,3.01,FALSE,131,136,267,3.1
311,Black,30,Female,2.41,TRUE,156,145,301,3.58
044,White,25,Female,2.51,TRUE,139,130,269,3.35
147,Hispanic,26,Female,2.59,TRUE,156,141,297,3.19
013,White,20,Female,2.91,FALSE,161,131,292,3.08
0564,Hispanic,25,Male,2.24,FALSE,131,135,266,3.69
597,Hispanic,25,Female,3.21,TRUE,147,133,280,3.29
361,White,22,Male,2.46,TRUE,152,145,297,3.76
1973,White,22,Female,1.13,FALSE,170,166,336,3.82
471,White,24,Female,2.06,TRUE,158,152,310,3.13
117,Asian,20,Male,2.65,TRUE,156,143,299,3.11
578,White,30,Male,2.61,TRUE,153,138,291,3.57
430,Bi-Racial,23,Trans*,2.72,FALSE,138,141,279,3.68
067,Hispanic,20,Male,2.65,FALSE,155,132,287,3.42
0136,White,23,Female,2.47,FALSE,132,144,276,3.09
665,White,24,Female,2.6,TRUE,150,135,285,2.88
226,Hispanic,21,Female,2.9,FALSE,148,138,286,2.54
1675,White,25,Trans*,2.09,FALSE,156,159,315,2.36
1828,White,25,Female,2.08,FALSE,147,162,309,3.81
1896,White,30,Trans*,1.48,FALSE,154,156,310,1.69
097,White,30,Trans*,2.56,TRUE,141,137,278,3.12
767,White,24,Female,2.62,FALSE,140,131,271,3
1389,Asian,27,Trans*,2.41,FALSE,140,145,285,2.3
0027,White,29,Trans*,1.84,FALSE,148,154,302,2.74
688,White,30,Trans*,2.1,TRUE,168,137,305,3.92
0553,Asian,29,Male,1.12,FALSE,131,144,275,2.66
591,White,28,Female,2.99,FALSE,140,131,271,3.19
002,Black,25,Trans*,2.82,FALSE,148,140,288,2.4
690,White,27,Female,3.14,FALSE,160,143,303,3.07
740,Asian,25,Female,2.2,TRUE,148,131,279,3.53
312,White,23,Male,2.62,FALSE,134,135,269,3.26
414,White,22,Female,2.88,FALSE,142,135,277,2.08
0844,Hispanic,24,Trans*,1.26,FALSE,168,155,323,2.81
229,White,27,Trans*,2.63,FALSE,164,149,313,2.83
280,White,25,Female,3.01,TRUE,137,146,283,3.42
1830,Hispanic,25,Male,2.11,FALSE,149,130,279,3.19
0273,Hispanic,26,Female,3.87,FALSE,147,133,280,3.38
404,White,30,Male,2.81,FALSE,149,131,280,3.17
1355,Hispanic,22,Trans*,2.71,FALSE,153,170,323,3.83
0734,Hispanic,25,Female,2.31,FALSE,154,155,309,3.96
1835,Black,20,Male,3.56,FALSE,135,170,305,3.39
0592,Asian,21,Male,3.74,FALSE,165,155,320,3.35
669,White,29,Trans*,2.6,TRUE,135,144,279,2.4
447,White,30,Trans*,2.29,FALSE,150,130,280,2.86
1348,White,24,Male,1.21,FALSE,150,161,311,3.58
1608,White,30,Trans*,2.43,FALSE,133,164,297,2.35
0365,Hispanic,21,Male,1.77,FALSE,135,142,277,2.99
1358,Hispanic,21,Trans*,2.13,FALSE,149,151,300,3.5
602,Hispanic,29,Female,1.91,FALSE,132,140,272,3.04
042,Hispanic,20,Male,2.07,TRUE,151,134,285,2
0767,White,26,Female,2.33,FALSE,145,152,297,3.54
586,White,25,Trans*,1.5,TRUE,135,137,272,3.23
0891,Black,25,Trans*,1.64,FALSE,146,167,313,2.91
0829,White,20,Female,1.76,FALSE,130,166,296,3.63
331,Hispanic,29,Trans*,2.82,FALSE,163,142,305,2.68
683,White,23,Trans*,2.4,TRUE,149,133,282,3.82
637,Hispanic,25,Trans*,3.21,FALSE,155,135,290,2.91
1719,Hispanic,24,Female,3.43,FALSE,147,168,315,2.92
1532,White,21,Male,3.11,FALSE,133,159,292,3.52
0911,Hispanic,25,Female,3.88,FALSE,149,142,291,3.99
1674,White,20,Male,3.79,FALSE,137,159,296,3.84
0777,Black,26,Male,2.81,FALSE,144,131,275,3.62
036,Hispanic,26,Trans*,1.53,TRUE,140,139,279,3.75
1093,White,22,Male,1.04,FALSE,150,168,318,2.92
580,Black,20,Trans*,2.65,TRUE,159,134,293,3.1
1766,White,28,Trans*,3.61,FALSE,148,133,281,3.98
641,White,29,Female,2.04,FALSE,138,134,272,3.41
1130,Hispanic,24,Male,3.44,FALSE,140,136,276,1.73
1461,White,25,Female,1.82,FALSE,135,163,298,3.9
503,Black,23,Male,1.81,TRUE,144,136,280,3.5
1701,Asian,25,Female,3.24,FALSE,137,144,281,2.98
671,White,24,Trans*,3.12,TRUE,131,136,267,2.91
497,White,26,Male,2.4,TRUE,145,131,276,3.78
584,Black,21,Male,2.76,FALSE,169,138,307,3.81
104,Black,24,Male,2.74,FALSE,154,133,287,3.32
404,Hispanic,26,Male,2.51,TRUE,152,135,287,3.9
1099,Asian,27,Female,2.09,FALSE,134,155,289,3.2
1723,White,27,Male,1.38,FALSE,159,166,325,3.28
0807,White,26,Male,2.28,FALSE,154,133,287,3.27
0635,White,28,Female,2.17,FALSE,149,170,319,3.03
018,White,30,Male,2.2,TRUE,167,134,301,3.34
1065,White,28,Female,3.42,FALSE,145,163,308,3.61
0458,White,27,Female,2.38,FALSE,136,154,290,3.66
484,White,23,Female,2.11,FALSE,130,130,260,2.62
161,White,26,Female,2.51,TRUE,148,144,292,2.61
0511,White,30,Trans*,1.72,FALSE,160,132,292,2.32
0121,White,25,Trans*,2.38,FALSE,153,154,307,3.52
233,Black,21,Male,3.89,FALSE,139,135,274,1.71
0301,White,28,Male,1.82,FALSE,140,159,299,3.48
237,White,25,Female,2.84,FALSE,138,134,272,3.32
486,White,21,Female,2.16,TRUE,159,131,290,2.56
608,White,25,Male,3.59,TRUE,151,136,287,2.96
761,White,24,Male,2.89,FALSE,145,145,290,3.25
1906,White,25,Trans*,1.19,FALSE,153,137,290,2.78
773,White,28,Male,2.36,FALSE,154,140,294,3.19
1929,White,23,Trans*,1.15,FALSE,152,143,295,1.26
1531,White,28,Trans*,3.1,FALSE,144,139,283,2.93
0854,White,27,Trans*,1.58,FALSE,143,145,288,2.77
261,White,24,Trans*,1.09,FALSE,151,130,281,2.62
0496,White,28,Male,3.39,FALSE,139,168,307,2.88
0643,White,21,Female,2.68,FALSE,155,165,320,3.19
1029,Black,27,Male,3.98,FALSE,149,151,300,2.29
0716,Black,25,Trans*,1.74,FALSE,133,155,288,3.85
278,White,22,Male,3.2,FALSE,153,132,285,2.81
073,White,22,Male,2.59,FALSE,133,133,266,2.62
025,White,20,Trans*,3.12,TRUE,148,131,279,2.38
1596,Hispanic,23,Male,2.98,FALSE,135,147,282,2.67
0645,Black,30,Male,3.11,FALSE,152,162,314,3.23
0080,White,21,Female,2.22,FALSE,136,167,303,3.5
644,Asian,20,Trans*,2.35,TRUE,149,143,292,3
1433,Black,26,Trans*,1.97,FALSE,148,160,308,2.6
468,White,22,Male,2.7,TRUE,153,135,288,2.6
1544,White,22,Male,2.66,FALSE,151,166,317,2.26
0493,Hispanic,20,Male,3.8,FALSE,149,162,311,3.66
1295,White,27,Female,2.13,FALSE,139,136,275,3.73
0278,Hispanic,28,Male,3.59,FALSE,138,140,278,2.23
1600,White,25,Trans*,2.46,FALSE,149,152,301,2.18
0966,White,27,Female,2.61,FALSE,146,149,295,3.99
0205,White,28,Female,2.96,FALSE,150,153,303,3.43
1268,White,25,Male,3.77,FALSE,142,158,300,3.23
236,White,22,Male,2.76,TRUE,170,130,300,3.61
1692,Black,23,Female,3.05,FALSE,140,134,274,2.68
1945,White,22,Female,3.56,FALSE,131,133,264,3.71
1925,White,28,Female,2.25,FALSE,138,132,270,2.6
0874,White,30,Male,1.38,FALSE,149,154,303,3.76
1725,White,23,Female,1.23,FALSE,160,145,305,3.49
163,White,29,Trans*,3.73,FALSE,150,131,281,2.45
0952,White,29,Trans*,2.96,FALSE,162,140,302,3.56
516,Hispanic,20,Male,2,TRUE,153,138,291,3.1
0140,White,30,Female,3.35,FALSE,144,161,305,2.13
0070,White,24,Trans*,3.02,FALSE,138,142,280,3.26
1359,White,30,Female,2.13,FALSE,167,132,299,3.67
0189,Hispanic,27,Female,3.67,FALSE,141,137,278,3.56
208,White,29,Male,2.72,FALSE,159,132,291,3.02
0099,White,26,Female,1.87,FALSE,133,140,273,2.34
016,Black,23,Female,2.22,TRUE,149,131,280,3.39
0427,White,24,Trans*,1.7,FALSE,157,158,315,3.12
291,White,24,Female,2.8,FALSE,152,131,283,3.12
0063,White,24,Trans*,2.57,FALSE,132,140,272,3.32
1444,White,27,Trans*,1.58,FALSE,135,148,283,3.64
0914,White,29,Male,3.59,FALSE,158,158,316,2.01
780,White,30,Male,2.35,TRUE,170,134,304,3.65
0933,White,26,Male,2.15,FALSE,149,152,301,2.78
656,White,23,Trans*,1.8,FALSE,135,130,265,2.71
546,White,30,Trans*,2.69,TRUE,130,139,269,2.52
559,Asian,29,Male,3.61,FALSE,146,134,280,3.49
180,Hispanic,27,Female,2.14,FALSE,152,132,284,3.19
742,White,20,Male,2.5,TRUE,131,154,285,2.75
0116,White,30,Female,1.61,FALSE,158,141,299,3.49
535,White,20,Female,2.51,FALSE,159,132,291,3.47
1390,White,20,Female,3.9,FALSE,163,131,294,2.63
0735,White,23,Female,2.39,FALSE,144,160,304,3.46
0409,Hispanic,30,Female,3.04,FALSE,135,134,269,1.88
626,Asian,28,Female,3.25,TRUE,157,139,296,3.39
1402,Hispanic,29,Male,1.26,FALSE,157,160,317,3.48
0337,Asian,26,Trans*,1.86,FALSE,137,147,284,3.97
686,White,20,Male,3.02,TRUE,147,131,278,3.17
1597,Black,20,Female,2.36,FALSE,150,153,303,1.59
1159,White,28,Male,1.14,FALSE,157,161,318,3.27
1975,White,25,Male,2.09,FALSE,157,150,307,2.83
595,White,29,Trans*,2.35,FALSE,142,137,279,3.57
1485,White,27,Trans*,2.84,FALSE,138,134,272,3.5
0837,White,23,Trans*,1.83,FALSE,158,148,306,3.15
0945,White,29,Male,1.49,FALSE,150,137,287,3.74
1430,Black,29,Female,3.42,FALSE,158,165,323,3.51
680,White,23,Male,2.62,FALSE,153,132,285,2.87
1021,Bi-Racial,20,Male,1.22,FALSE,151,157,308,3.7
705,White,24,Female,2.76,TRUE,147,144,291,3.61
0994,White,20,Female,3.58,FALSE,140,160,300,3.14
1314,White,22,Male,2.37,FALSE,132,162,294,3.2
248,White,27,Female,2.16,TRUE,149,136,285,3.6
678,White,28,Male,2.8,FALSE,144,134,278,3.32
214,Hispanic,30,Female,2.7,TRUE,144,145,289,3.13
037,Asian,22,Male,1.98,FALSE,153,145,298,3.19
167,White,26,Male,2.85,TRUE,153,138,291,2.99
0669,Hispanic,28,Trans*,1.92,FALSE,147,163,310,3.06
1639,Asian,24,Trans*,3.14,FALSE,144,168,312,3.3
0479,Hispanic,25,Male,2.14,FALSE,154,159,313,2.01
056,White,29,Male,1.84,TRUE,151,140,291,3.37
010,White,24,Male,2.22,TRUE,155,141,296,3.94
517,Hispanic,26,Trans*,2.06,FALSE,151,136,287,3.74
190,Hispanic,29,Male,2.49,TRUE,136,132,268,3.56
0400,Hispanic,25,Trans*,1.65,FALSE,161,150,311,3.33
289,Hispanic,29,Male,2.45,TRUE,153,130,283,2.86
0174,White,24,Male,3.2,FALSE,159,131,290,2.84
0177,Hispanic,22,Male,2.34,FALSE,136,162,298,3.65
1481,Hispanic,24,Trans*,2.79,FALSE,164,139,303,3.97
558,Hispanic,22,Trans*,2.23,FALSE,158,142,300,2.98
752,White,25,Trans*,2.79,FALSE,136,149,285,3.36
126,White,23,Female,2.37,TRUE,157,131,288,2.94
0193,White,29,Trans*,2.09,FALSE,150,136,286,1.95
280,Hispanic,22,Trans*,1.79,FALSE,144,137,281,3.27
406,White,25,Trans*,2.85,TRUE,134,132,266,3.74
1542,White,20,Female,2.6,FALSE,139,165,304,2.85
193,Asian,23,Female,2.44,FALSE,164,134,298,2.49
1926,Native,28,Female,2.31,FALSE,151,131,282,1.78
562,White,25,Female,1.96,FALSE,165,132,297,3.11
0482,Hispanic,26,Female,3.05,FALSE,137,155,292,3.33
077,White,20,Male,2.56,TRUE,132,138,270,3.76
1962,Black,24,Male,1.97,FALSE,150,132,282,3.38
1751,White,30,Trans*,1.73,FALSE,159,154,313,3.11
0008,White,20,Trans*,2.55,FALSE,145,147,292,3.47
0192,White,30,Trans*,1.5,FALSE,141,159,300,2.85
199,Bi-Racial,28,Trans*,1.66,TRUE,165,138,303,3.11
432,White,20,Male,2.6,FALSE,138,141,279,2.96
499,White,28,Male,3.44,TRUE,136,138,274,3.29
716,White,25,Trans*,2.62,TRUE,138,131,269,3.19
1633,White,28,Trans*,2.85,FALSE,168,137,305,2.56
1610,Hispanic,21,Female,1.63,FALSE,140,163,303,2.91
0667,Asian,29,Trans*,3.95,FALSE,166,163,329,2.5
1877,Hispanic,20,Male,1.36,FALSE,147,144,291,3.09
1168,White,25,Trans*,1.21,FALSE,169,156,325,3.76
664,Asian,30,Trans*,2.22,FALSE,147,138,285,2.56
1947,White,26,Trans*,2.84,FALSE,135,153,288,2.84
1752,White,23,Male,3.41,FALSE,152,169,321,2.39
0979,Hispanic,26,Male,2.45,FALSE,137,142,279,2.84
179,White,25,Male,2.8,FALSE,144,145,289,3.1
190,Asian,30,Male,2.23,FALSE,150,144,294,3.19
0058,White,26,Trans*,2.12,FALSE,152,162,314,3.68
1646,White,26,Male,3.66,FALSE,152,162,314,3.45
794,White,26,Male,2.8,TRUE,139,138,277,2.39
1082,White,21,Female,1.36,FALSE,130,151,281,2.36
0212,White,28,Male,2.67,FALSE,134,157,291,2.51
1717,Black,30,Male,3.07,FALSE,168,159,327,2.28
1619,Black,20,Male,3.92,FALSE,139,139,278,3.39
357,White,30,Female,3.15,FALSE,130,131,261,2.4
1028,White,21,Trans*,2.23,FALSE,134,167,301,3.58
1128,Bi-Racial,26,Male,2.16,FALSE,161,169,330,2.22
461,White,22,Female,3.05,FALSE,151,145,296,2.37
0698,White,30,Female,2.52,FALSE,150,141,291,2.91
1726,Black,30,Male,1.57,FALSE,135,169,304,2.75
0594,White,27,Male,3.07,FALSE,147,149,296,2.84
0053,Black,30,Trans*,3.17,FALSE,152,149,301,3.18
351,White,26,Trans*,2.39,TRUE,134,141,275,3.81
1660,Black,24,Male,1.68,FALSE,140,168,308,3.73
1491,White,25,Female,1.04,FALSE,135,137,272,1.43
0012,Other,26,Trans*,3.06,FALSE,158,147,305,3.59
0693,White,22,Female,1.23,FALSE,154,133,287,2.73
621,White,24,Female,1.73,FALSE,144,134,278,3.32
0870,White,24,Male,2.45,FALSE,160,151,311,3.61
0024,White,26,Male,3.69,FALSE,139,134,273,3
0986,White,29,Female,2.51,FALSE,150,137,287,3.94
1940,White,20,Female,1.01,FALSE,147,142,289,2.46
1343,Hispanic,30,Male,2.15,FALSE,136,166,302,3.36
366,Bi-Racial,26,Male,1.92,TRUE,135,134,269,3.05
1955,Hispanic,27,Male,2.92,FALSE,140,135,275,2.64
405,Bi-Racial,23,Trans*,2.3,FALSE,149,135,284,3.45
288,White,25,Male,2.75,TRUE,157,145,302,3.54
1026,Hispanic,21,Male,3.56,FALSE,155,130,285,3.64
1523,Hispanic,29,Trans*,3.3,FALSE,152,149,301,3.18
1049,Hispanic,24,Male,1.47,FALSE,130,141,271,2.95
1374,Hispanic,24,Trans*,3.53,FALSE,151,160,311,2.83
1411,Asian,20,Female,3.08,FALSE,138,164,302,2.51
348,Hispanic,25,Trans*,2.54,TRUE,132,138,270,3.72
599,White,20,Female,2.45,FALSE,161,134,295,1.93
642,White,30,Male,2.35,FALSE,161,135,296,2.95
1657,Asian,25,Female,3.91,FALSE,142,147,289,2.62
0965,Hispanic,21,Male,2.26,FALSE,170,153,323,2.14
631,Black,29,Female,1.76,TRUE,133,134,267,3
149,Hispanic,25,Male,2.34,FALSE,151,136,287,3.01
359,White,23,Male,3.36,TRUE,133,136,269,3.74
628,Asian,26,Trans*,1.57,TRUE,142,131,273,3.15
1810,Black,21,Female,3.53,FALSE,133,144,277,3.78
241,White,21,Male,2.07,FALSE,133,131,264,2.87
498,Black,24,Trans*,2.93,FALSE,156,132,288,2.8
1284,White,22,Male,3.51,FALSE,166,165,331,1.65
250,Hispanic,22,Female,2.3,FALSE,147,141,288,2.93
0753,Black,25,Female,1.8,FALSE,141,166,307,3.56
0811,White,27,Trans*,2.73,FALSE,155,159,314,3.36
0586,Black,22,Male,3.26,FALSE,161,162,323,3.43
300,White,27,Female,2.81,TRUE,140,133,273,2.69
706,White,28,Male,2.14,TRUE,168,155,323,3.08
590,White,22,Male,3.3,TRUE,149,139,288,3.43
052,White,20,Female,2.12,FALSE,160,133,293,3.47
0142,White,26,Female,3.03,FALSE,165,143,308,3.04
1865,Bi-Racial,28,Male,2.38,FALSE,146,151,297,2.45
090,Black,22,Male,2.03,TRUE,152,136,288,2.94
104,White,29,Trans*,2.72,TRUE,147,134,281,3.21
728,White,27,Male,2.53,FALSE,131,142,273,2.63
564,Black,27,Trans*,2.58,FALSE,168,133,301,3.06
400,White,21,Female,2.77,TRUE,159,133,292,3.25
0416,White,22,Trans*,1.46,FALSE,147,137,284,1.02
1888,White,29,Male,2.52,FALSE,161,168,329,3.74
707,White,23,Male,2.53,TRUE,149,134,283,3.48
0936,White,25,Trans*,3.18,FALSE,159,131,290,3.55
246,White,27,Trans*,3.54,TRUE,134,130,264,3.09
1158,Hispanic,27,Female,2.35,FALSE,158,158,316,1.83
1328,Asian,20,Trans*,3.5,FALSE,151,162,313,3.25
1145,Bi-Racial,30,Female,1.91,FALSE,148,168,316,3.03
1384,White,25,Trans*,1.13,FALSE,156,167,323,3.6
067,White,24,Male,2.24,TRUE,143,130,273,3.64
1156,White,20,Trans*,1.97,FALSE,135,154,289,3.15
1584,White,23,Female,1.53,FALSE,144,137,281,2.65
0234,White,30,Trans*,2.43,FALSE,163,145,308,2.79
0988,Hispanic,24,Female,3.01,FALSE,141,137,278,1.77
0876,White,21,Male,3.08,FALSE,145,154,299,3.92
0889,White,23,Male,3.34,FALSE,144,143,287,3.96
627,White,27,Trans*,1.7,TRUE,160,137,297,3.74
417,White,23,Female,1.89,TRUE,161,131,292,2.81
060,White,23,Trans*,2.38,FALSE,144,139,283,2.98
149,Bi-Racial,20,Male,2.46,TRUE,142,131,273,3.19
174,White,24,Trans*,1.92,TRUE,152,131,283,3.55
1376,White,29,Trans*,2.92,FALSE,141,145,286,1.43
333,Asian,21,Female,2.65,TRUE,150,133,283,3.31
019,White,22,Trans*,3.1,TRUE,164,132,296,2.56
623,Hispanic,28,Female,3.3,TRUE,135,135,270,3.7
0148,White,25,Female,2.44,FALSE,162,152,314,3.53
020,White,20,Male,2.88,TRUE,159,134,293,3.4
605,White,22,Female,2.39,FALSE,153,142,295,2.75
0893,White,21,Trans*,3.5,FALSE,144,168,312,3.92
0639,White,28,Trans*,1.37,FALSE,151,167,318,4
204,Hispanic,20,Female,3.17,FALSE,133,135,268,3.83
057,Black,28,Female,2.16,FALSE,145,133,278,3.54
242,White,26,Trans*,1.41,TRUE,149,130,279,3.29
0524,White,24,Trans*,3.27,FALSE,169,161,330,2.81
610,White,27,Female,2.57,TRUE,144,136,280,2.51
1879,White,27,Female,1.37,FALSE,145,141,286,3.62
0581,White,26,Male,2.27,FALSE,138,134,272,3.01
0853,White,30,Male,3.84,FALSE,160,140,300,3.8
0448,White,28,Trans*,1.54,FALSE,167,146,313,3.89
219,White,20,Male,2.01,TRUE,154,137,291,3.64
1715,White,26,Female,1.36,FALSE,136,165,301,2.11
0119,White,20,Male,3.03,FALSE,139,150,289,3.13
0751,Hispanic,20,Female,3.96,FALSE,139,159,298,3.74
087,White,22,Female,2.69,FALSE,154,133,287,3.84
0733,Native,30,Trans*,2.27,FALSE,165,163,328,2.75
0554,White,21,Female,1.56,FALSE,161,144,305,3.63
1078,White,23,Trans*,2.53,FALSE,134,148,282,2.92
0941,White,21,Male,2.01,FALSE,164,149,313,3.58
484,White,25,Female,1.88,TRUE,134,131,265,3.87
142,Bi-Racial,28,Trans*,1.79,TRUE,145,131,276,3.56
181,Hispanic,29,Trans*,2.73,FALSE,167,135,302,3.59
0991,White,27,Male,1.74,FALSE,150,138,288,3.74
755,White,20,Trans*,3.24,TRUE,145,137,282,3.36
1292,White,25,Trans*,3.03,FALSE,138,158,296,2.93
1595,White,26,Trans*,2.81,FALSE,152,145,297,2.64
077,White,28,Male,2.04,FALSE,170,131,301,2.85
0194,White,24,Male,1.45,FALSE,162,140,302,3.67
0370,White,21,Male,1.6,FALSE,169,132,301,3.38
1903,White,30,Female,3.63,FALSE,139,148,287,3.12
0347,White,28,Female,1.24,FALSE,145,168,313,3.47
1486,White,28,Female,1.6,FALSE,155,145,300,2.87
327,White,28,Trans*,1.7,FALSE,142,137,279,3.35
0628,Native,21,Male,1.63,FALSE,133,156,289,2.18
1735,White,30,Trans*,3.29,FALSE,132,165,297,1.11
1706,Black,24,Trans*,3.32,FALSE,148,144,292,3.95
128,White,23,Male,2.79,FALSE,149,136,285,3.88
700,Asian,26,Male,2.44,FALSE,140,134,274,3.76
0476,Native,24,Male,3.44,FALSE,156,167,323,3.52
0218,White,29,Male,3.58,FALSE,163,130,293,3.5
792,White,28,Male,2.61,TRUE,145,136,281,3.99
504,White,27,Female,1.9,TRUE,161,144,305,2.97
0285,White,22,Female,1.75,FALSE,141,149,290,2.67
128,White,23,Female,3.4,TRUE,162,130,292,2.98
040,Black,26,Trans*,3.23,TRUE,167,142,309,3.45
221,White,27,Female,2.62,TRUE,144,134,278,3.41
1625,Bi-Racial,30,Female,3.65,FALSE,133,146,279,3.69
0506,White,29,Male,2.61,FALSE,132,141,273,3.09
1800,Hispanic,28,Trans*,3.03,FALSE,132,143,275,2.54
777,Black,23,Female,3.05,FALSE,159,138,297,2.89
0266,Black,25,Female,2.57,FALSE,146,166,312,3.89
0500,White,29,Trans*,2.59,FALSE,146,151,297,2.63
1340,Hispanic,26,Male,2.22,FALSE,147,148,295,3.1
177,White,27,Male,3.17,FALSE,133,134,267,3.68
493,Black,28,Male,2.92,TRUE,147,142,289,3.62
277,Black,26,Male,2.6,TRUE,135,136,271,2.33
0137,White,27,Female,1.16,FALSE,160,147,307,3.53
454,Asian,30,Male,3.11,TRUE,145,131,276,3.18
1574,Native,27,Female,1.41,FALSE,148,163,311,1.92
426,White,25,Male,3.67,FALSE,159,143,302,3.56
507,Hispanic,27,Female,2.44,TRUE,134,138,272,3.2
0663,Black,22,Female,3.15,FALSE,154,158,312,2.66
718,White,28,Male,2.58,TRUE,144,131,275,3.03
601,White,30,Trans*,2.78,FALSE,158,136,294,3.47
316,White,28,Male,2.2,TRUE,163,131,294,3.25
714,White,28,Male,3.06,FALSE,138,133,271,2.58
723,Bi-Racial,26,Male,2.55,TRUE,139,151,290,3.81
0725,White,27,Trans*,2.12,FALSE,134,137,271,2.61
0117,White,20,Male,2.15,FALSE,158,163,321,2.72
205,White,30,Trans*,2.69,FALSE,131,130,261,3.15
764,White,26,Female,2.69,TRUE,154,137,291,3.25
480,White,27,Female,1.82,FALSE,159,141,300,2.63
279,White,26,Trans*,2.97,TRUE,156,137,293,3.67
1664,White,27,Trans*,2.81,FALSE,157,146,303,1.86
1932,White,22,Trans*,2.51,FALSE,157,150,307,3.17
715,White,25,Female,2.52,FALSE,159,132,291,2.75
336,White,27,Female,3.14,TRUE,138,131,269,2.53
1915,White,29,Male,1.14,FALSE,137,163,300,3.03
743,Black,25,Female,2.9,FALSE,155,135,290,1.57
014,Asian,24,Female,1.87,TRUE,142,135,277,3.58
0813,Black,23,Female,2.33,FALSE,140,166,306,3.5
055,White,23,Female,1.83,FALSE,144,136,280,3.31
0928,Black,21,Female,1.11,FALSE,152,153,305,3.28
418,White,29,Trans*,1.97,FALSE,165,130,295,3.32
0411,Hispanic,24,Female,1.89,FALSE,166,131,297,3.28
0644,Black,26,Male,2.38,FALSE,142,139,281,3.71
1739,Hispanic,23,Female,3.75,FALSE,147,155,302,3.95
663,Black,26,Male,3.22,TRUE,161,134,295,2.5
0787,White,20,Trans*,2.99,FALSE,132,132,264,2.57
0992,Hispanic,21,Trans*,3.1,FALSE,150,160,310,2.66
215,Hispanic,30,Female,2.8,FALSE,152,135,287,3.15
705,White,28,Trans*,2.97,FALSE,136,133,269,2.02
1087,White,28,Trans*,2.36,FALSE,137,163,300,3.16
448,White,22,Male,2.94,TRUE,157,131,288,3.3
0132,White,24,Male,1.17,FALSE,139,169,308,3.02
1202,Hispanic,24,Trans*,1.9,FALSE,156,164,320,3.63
1310,Hispanic,27,Trans*,2.79,FALSE,156,159,315,2.47
663,White,29,Female,3.45,FALSE,163,140,303,3.36
1182,Black,20,Male,2.85,FALSE,136,133,269,3.29
088,Bi-Racial,30,Male,2.6,FALSE,141,136,277,2.37
0462,Hispanic,29,Male,1.72,FALSE,153,146,299,3.73
1548,Hispanic,22,Trans*,2.91,FALSE,166,138,304,3.48
115,Hispanic,23,Trans*,2.33,FALSE,135,151,286,2.16
0111,White,29,Female,3.75,FALSE,159,146,305,2.31
1280,White,20,Male,1.4,FALSE,151,161,312,3.61
0699,White,22,Male,2.42,FALSE,165,146,311,3.28
0402,Asian,25,Male,3.35,FALSE,133,169,302,3.51
388,White,24,Male,3.35,TRUE,145,139,284,2.8
0167,White,21,Male,1.52,FALSE,139,146,285,3.77
1387,White,28,Female,2.78,FALSE,164,150,314,3.31
1545,Black,24,Trans*,2.39,FALSE,169,147,316,2.83
0739,White,22,Trans*,1.06,FALSE,146,138,284,2.39
1098,White,25,Female,1.71,FALSE,166,134,300,3.92
0275,Black,25,Trans*,1.39,FALSE,137,147,284,2.43
340,Hispanic,24,Trans*,3.12,FALSE,140,139,279,2.2
1645,White,21,Female,1.97,FALSE,138,161,299,3.09
133,White,29,Male,1.66,TRUE,142,131,273,3.32
434,Hispanic,22,Trans*,3.26,FALSE,147,150,297,3.47
0091,Hispanic,28,Female,3.07,FALSE,156,145,301,2.31
0783,White,20,Female,1.8,FALSE,141,133,274,2.72
0472,White,24,Trans*,2.35,FALSE,141,151,292,1.5
528,White,23,Male,2.07,FALSE,137,141,278,2.65
1303,White,21,Male,2.56,FALSE,137,166,303,2.72
1728,White,29,Male,2.89,FALSE,146,158,304,2.04
0951,White,24,Male,2.84,FALSE,151,159,310,2.84
479,Hispanic,22,Male,1.97,TRUE,153,142,295,3.45
670,White,24,Trans*,3.22,FALSE,133,131,264,3.76
167,White,20,Trans*,2.79,FALSE,142,134,276,3.86
0905,Black,21,Trans*,1.05,FALSE,167,170,337,2.46
754,White,26,Male,2.95,FALSE,149,135,284,2.52
1980,Asian,22,Female,3.33,FALSE,149,138,287,3.27
374,White,20,Female,2.16,TRUE,150,136,286,2.92
0960,White,28,Male,1.43,FALSE,140,148,288,1.98
005,Black,29,Male,3.39,TRUE,161,134,295,3.55
1658,Black,22,Trans*,2.06,FALSE,137,141,278,2.56
0297,White,21,Trans*,2.9,FALSE,160,139,299,2.84
191,Hispanic,30,Male,2.75,TRUE,160,132,292,3.3
1747,White,23,Male,1.59,FALSE,145,145,290,3.49
157,White,23,Trans*,2.36,FALSE,138,131,269,2.96
555,Black,20,Trans*,2.55,TRUE,148,134,282,3.33
0449,White,29,Male,2.18,FALSE,135,152,287,2.5
1630,Hispanic,22,Male,2.4,FALSE,162,132,294,3.97
0386,White,23,Male,1.52,FALSE,133,166,299,3.17
334,White,30,Male,3.28,TRUE,143,131,274,3.1
0614,Hispanic,27,Trans*,1.56,FALSE,151,155,306,3.34
1018,White,23,Trans*,1.55,FALSE,150,134,284,1.83
272,Hispanic,26,Trans*,2.48,TRUE,163,139,302,3.28
1499,White,28,Trans*,2.42,FALSE,154,143,297,2.07
347,Black,25,Female,3.28,FALSE,161,134,295,2.94
245,White,25,Male,2.97,FALSE,154,134,288,3.15
1802,White,25,Trans*,1.81,FALSE,133,142,275,2.59
549,Bi-Racial,29,Female,2.65,TRUE,134,131,265,2.62
462,Black,23,Female,1.95,TRUE,137,132,269,3.35
033,White,24,Female,2.37,TRUE,164,139,303,2.88
135,White,22,Male,3.2,FALSE,138,133,271,3.54
1416,Black,21,Female,2.86,FALSE,168,136,304,2.74
715,White,26,Female,3.51,TRUE,153,135,288,3.59
1105,White,23,Trans*,1.58,FALSE,149,131,280,2.96
0633,Hispanic,20,Trans*,1.89,FALSE,130,142,272,2.58
0100,Black,23,Female,2.83,FALSE,148,154,302,2.71
0221,White,28,Male,3.58,FALSE,165,151,316,3.08
739,Bi-Racial,21,Male,2.34,TRUE,141,134,275,3.21
654,Black,24,Trans*,1.84,FALSE,156,139,295,2.42
262,Hispanic,29,Trans*,2.67,FALSE,160,136,296,3.13
1668,White,29,Male,3.35,FALSE,156,152,308,2.4
216,Asian,28,Male,2.1,TRUE,142,132,274,2.63
1789,White,30,Trans*,2.22,FALSE,151,169,320,2.82
0559,Black,27,Male,1.84,FALSE,169,169,338,3.71
372,White,26,Male,1.92,FALSE,149,131,280,2.98
366,White,21,Trans*,2.42,FALSE,143,135,278,2.78
0001,White,26,Female,3.46,FALSE,130,159,289,2.97
0588,Hispanic,26,Male,2.71,FALSE,161,142,303,3.49
0570,Black,22,Trans*,3.13,FALSE,144,141,285,3.39
0681,White,23,Trans*,3.67,FALSE,151,153,304,3.86
1321,White,24,Female,3.18,FALSE,149,130,279,2.37
145,White,25,Trans*,2.84,TRUE,151,137,288,3.68
671,Hispanic,20,Trans*,2.42,FALSE,134,137,271,2.4
1613,White,24,Female,2.67,FALSE,131,145,276,3.53
651,White,30,Female,1.78,FALSE,155,135,290,2.18
614,White,28,Female,2.65,FALSE,155,141,296,3.68
385,Hispanic,26,Female,2.35,FALSE,152,139,291,2.45
1298,White,22,Male,1,FALSE,137,150,287,3.65
0815,White,29,Male,2.77,FALSE,147,153,300,3.24
0842,White,21,Trans*,1.74,FALSE,140,157,297,2.55
1576,White,30,Female,2.41,FALSE,133,153,286,3.76
677,White,24,Trans*,1.94,TRUE,146,145,291,3.51
178,White,27,Female,2.4,TRUE,142,141,283,3.17
0763,White,22,Trans*,3.5,FALSE,132,153,285,3.41
519,Asian,25,Trans*,3.43,FALSE,153,131,284,3.47
624,White,22,Male,3.05,FALSE,152,141,293,3.66
0603,Black,26,Female,3.57,FALSE,133,135,268,2.96
1141,White,29,Trans*,1.5,FALSE,149,162,311,2.65
656,White,30,Male,1.67,TRUE,146,136,282,2.97
424,Black,29,Male,2.75,FALSE,137,137,274,2.84
1438,Hispanic,28,Male,3.97,FALSE,135,152,287,3.11
302,White,24,Trans*,3.32,FALSE,160,131,291,3.69
0550,White,23,Female,3.05,FALSE,140,169,309,3.15
1510,White,27,Male,3.11,FALSE,140,159,299,3.29
1750,White,25,Trans*,3.65,FALSE,161,155,316,2.41
0457,White,25,Male,1.08,FALSE,159,144,303,1.93
435,Asian,28,Trans*,1.65,FALSE,135,151,286,2.68
590,White,20,Trans*,3.23,FALSE,148,137,285,2.55
1601,White,24,Female,3.2,FALSE,158,132,290,2.23
105,White,25,Trans*,2.79,TRUE,143,133,276,3.02
1626,Black,28,Trans*,3.67,FALSE,155,156,311,1.77
1039,Hispanic,24,Female,3.09,FALSE,149,170,319,3.35
1759,White,23,Female,2.92,FALSE,137,168,305,2.43
023,White,30,Female,3.97,TRUE,143,140,283,3.72
0513,Black,23,Female,2.55,FALSE,150,159,309,3.89
072,White,21,Female,3.13,FALSE,168,132,300,2.82
029,Black,20,Female,2.69,TRUE,150,138,288,3.38
776,White,25,Male,2.29,TRUE,155,133,288,3.91
0209,Asian,28,Male,2.92,FALSE,145,141,286,2.98
621,Asian,24,Male,2.14,TRUE,140,133,273,2.86
470,White,30,Male,2.76,FALSE,158,131,289,2.47
0714,White,23,Female,1.91,FALSE,148,155,303,3.12
106,White,29,Trans*,2.21,FALSE,147,147,294,2.77
259,White,30,Male,2.16,TRUE,143,141,284,3.63
786,Hispanic,22,Female,2.95,TRUE,158,140,298,2.96
0395,Hispanic,20,Trans*,1.49,FALSE,159,153,312,3.31
095,White,24,Male,2.1,TRUE,150,134,284,3.11
0364,White,28,Trans*,1.17,FALSE,142,153,295,2.28
0504,White,23,Female,3.45,FALSE,138,145,283,3.27
0685,White,22,Female,2.84,FALSE,139,138,277,3.9
0254,Black,22,Male,1.16,FALSE,144,151,295,3.4
730,White,24,Trans*,2.56,FALSE,149,131,280,3
0187,White,21,Female,3.11,FALSE,133,143,276,1.63
0284,White,21,Male,3.68,FALSE,134,169,303,3.1
0598,Black,25,Trans*,2.6,FALSE,133,146,279,3.99
368,White,30,Male,3.22,TRUE,135,134,269,3.14
009,Black,20,Male,2.35,FALSE,150,131,281,2.76
107,White,26,Male,3.61,FALSE,143,137,280,3.51
1647,Asian,24,Female,2.3,FALSE,133,138,271,1.9
0302,White,25,Female,2.4,FALSE,138,131,269,3.14
315,White,27,Female,3.02,FALSE,142,135,277,2.85
1568,White,26,Female,1.35,FALSE,146,133,279,2.08
0970,White,30,Male,1.94,FALSE,145,161,306,2.21
0226,Black,24,Male,1.1,FALSE,156,164,320,2.58
389,White,22,Trans*,2.87,FALSE,168,138,306,2.46
483,Black,25,Female,1.97,FALSE,147,138,285,2.72
646,Hispanic,24,Male,1.77,FALSE,143,131,274,2.9
0487,White,28,Trans*,2.64,FALSE,155,145,300,3.73
242,Hispanic,30,Female,1.88,FALSE,131,134,265,3.78
0469,White,23,Trans*,1.02,FALSE,144,145,289,2.94
296,Black,20,Male,2.24,FALSE,142,141,283,2.14
778,Black,26,Male,1.56,FALSE,134,133,267,1.98
1005,White,23,Male,1.21,FALSE,149,138,287,3.95
1744,White,27,Female,1.87,FALSE,133,137,270,3.43
771,White,26,Male,2.96,FALSE,133,136,269,3.61
0741,White,20,Male,2.82,FALSE,158,151,309,2.11
226,White,24,Male,3.24,TRUE,146,132,278,3.43
0248,White,21,Female,1.19,FALSE,157,155,312,2.27
482,White,22,Male,2.66,TRUE,135,131,266,3.3
649,White,23,Female,3.99,FALSE,139,138,277,2.87
566,Black,27,Female,2.47,TRUE,140,138,278,3.46
1223,White,22,Female,2.65,FALSE,161,147,308,2.98
438,Asian,28,Trans*,1.87,TRUE,168,131,299,2.75
0727,White,27,Female,1.17,FALSE,151,162,313,2.35
0429,White,30,Trans*,3.72,FALSE,143,134,277,2.67
044,Black,23,Female,2.69,FALSE,137,132,269,2.93
324,White,29,Male,2.64,TRUE,158,144,302,3.2
0349,Hispanic,27,Female,1.14,FALSE,145,138,283,3.06
047,Hispanic,22,Male,2.19,TRUE,150,132,282,3.27
108,White,25,Trans*,1.89,TRUE,146,133,279,2.52
1927,White,24,Female,1.94,FALSE,147,151,298,1.6
013,White,30,Trans*,2.73,TRUE,149,143,292,3.74
614,White,23,Male,2.48,TRUE,145,132,277,3.13
0247,White,28,Male,3.92,FALSE,131,136,267,3.51
075,White,22,Trans*,2.08,FALSE,149,138,287,2.85
1556,White,27,Male,2.28,FALSE,135,156,291,3.58
0826,White,21,Male,2.86,FALSE,167,158,325,3.64
1522,White,27,Male,1.53,FALSE,141,144,285,3.51
1609,Asian,22,Trans*,3.32,FALSE,132,143,275,2.7
553,Asian,23,Trans*,3.34,FALSE,168,132,300,3.3
1114,Hispanic,22,Female,1.75,FALSE,154,137,291,2.17
0087,Black,21,Male,1.81,FALSE,150,139,289,3.72
1707,White,21,Trans*,2.66,FALSE,149,159,308,2.69
0861,White,29,Male,2.88,FALSE,139,138,277,1.96
323,White,26,Trans*,2.14,TRUE,153,156,309,3.53
0989,Black,21,Trans*,2.06,FALSE,166,164,330,3.74
279,Native,21,Female,1.39,FALSE,157,140,297,3.05
490,White,21,Male,2.6,FALSE,145,146,291,2.56
0816,Asian,26,Male,3.82,FALSE,134,162,296,3.37
0213,Hispanic,26,Female,2.78,FALSE,157,136,293,2.71
1876,White,29,Female,2.89,FALSE,143,136,279,2.29
0625,White,30,Trans*,1.29,FALSE,163,149,312,3.88
0773,White,22,Female,3.03,FALSE,131,155,286,2.04
321,White,28,Male,2.42,TRUE,160,132,292,2.61
048,White,25,Male,2.37,TRUE,148,147,295,3.8
744,White,29,Male,3.46,TRUE,130,133,263,2.72
1360,White,22,Female,3.96,FALSE,159,161,320,3.32
0003,White,22,Male,3.63,FALSE,136,150,286,3.02
1573,White,27,Female,2.76,FALSE,156,139,295,3.41
0661,White,30,Male,3.49,FALSE,156,162,318,2.34
420,Asian,22,Male,1.47,FALSE,142,140,282,2.26
730,Bi-Racial,26,Male,2.44,TRUE,157,132,289,3.64
438,White,28,Female,3.02,FALSE,142,131,273,3.62
0372,Hispanic,28,Female,2.6,FALSE,148,136,284,3.72
0049,White,26,Male,3.65,FALSE,150,164,314,2.88
0978,White,29,Female,1.2,FALSE,149,149,298,3.4
0680,White,26,Male,2.8,FALSE,130,145,275,3.37
011,Hispanic,24,Trans*,2.34,TRUE,157,143,300,2.45
0770,Hispanic,26,Male,3.03,FALSE,136,142,278,3.82
0348,Asian,30,Trans*,3.97,FALSE,161,160,321,2.7
0046,White,28,Trans*,1.19,FALSE,143,136,279,3.41
617,White,30,Trans*,2.05,TRUE,148,143,291,3.39
588,Bi-Racial,23,Male,2.77,TRUE,151,133,284,2.42
680,Asian,21,Male,2.74,TRUE,143,131,274,3.32
033,White,22,Male,3.38,FALSE,146,136,282,2.9
192,Native,23,Female,2.3,TRUE,149,148,297,3.49
0011,Hispanic,21,Male,3.37,FALSE,134,163,297,3.03
241,White,25,Trans*,2.95,TRUE,139,133,272,3.41
0401,White,26,Female,2.44,FALSE,152,139,291,2.54
032,White,29,Trans*,3.09,FALSE,152,137,289,2.8
1653,Hispanic,29,Female,2.29,FALSE,169,156,325,2.4
0277,White,24,Female,1.91,FALSE,158,160,318,3.92
573,White,30,Male,2.23,TRUE,137,141,278,3.57
0415,White,21,Trans*,2.45,FALSE,161,162,323,3.13
378,White,30,Female,1.6,TRUE,163,131,294,3.63
0244,Black,27,Trans*,1.37,FALSE,148,146,294,3.5
187,White,24,Female,2.18,FALSE,136,143,279,2.12
206,Hispanic,27,Trans*,2.28,TRUE,132,138,270,3.54
471,White,23,Female,2.36,FALSE,141,137,278,3.58
1353,Asian,28,Trans*,1.84,FALSE,168,156,324,2.07
1698,Hispanic,26,Female,2.93,FALSE,150,165,315,3.23
1477,White,25,Female,1.17,FALSE,154,150,304,3.26
332,Hispanic,25,Trans*,2.69,FALSE,142,132,274,2.75
1422,White,28,Trans*,1.85,FALSE,148,165,313,2.47
685,Black,30,Trans*,2.41,TRUE,137,134,271,2.52
0772,White,24,Trans*,3.45,FALSE,136,143,279,3.18
1498,White,21,Male,3.48,FALSE,149,151,300,2.29
196,White,24,Trans*,2.5,FALSE,150,163,313,2.36
120,Black,26,Female,2.07,FALSE,157,146,303,3.08
047,White,24,Male,3.75,FALSE,143,136,279,3.03
0591,Black,28,Trans*,2.99,FALSE,146,136,282,3.37
622,White,24,Female,2.56,FALSE,133,144,277,2.93
1090,White,27,Trans*,3.47,FALSE,153,161,314,3.27
0101,Hispanic,25,Trans*,1.23,FALSE,137,140,277,3.55
071,White,23,Male,3.04,FALSE,151,142,293,2.89
387,White,27,Female,2.76,FALSE,147,148,295,2.95
0465,White,28,Female,3.11,FALSE,145,149,294,2.59
382,Black,21,Trans*,1.87,FALSE,131,133,264,3.95
269,White,24,Trans*,2.79,TRUE,133,132,265,3.9
518,White,27,Trans*,2.78,TRUE,149,139,288,3.09
557,White,28,Trans*,2.31,FALSE,138,138,276,3.28
1072,Black,24,Female,1.58,FALSE,146,156,302,3.06
076,White,22,Female,2.47,TRUE,152,137,289,3.43
0075,White,25,Male,1.78,FALSE,163,154,317,3.01
0436,White,25,Female,1.86,FALSE,156,143,299,3.86
734,White,28,Female,3.31,FALSE,149,135,284,2.73
143,White,24,Trans*,2,FALSE,155,138,293,2.26
328,White,20,Male,2.8,TRUE,131,144,275,3.31
174,White,20,Female,1.99,FALSE,158,141,299,3.33
1083,Asian,22,Male,1.16,FALSE,153,158,311,3.82
0329,White,24,Male,3.33,FALSE,136,150,286,2.96
220,White,22,Female,2.45,FALSE,149,139,288,3.57
532,White,23,Male,3.16,FALSE,161,140,301,3.58
1656,White,20,Trans*,3.76,FALSE,137,136,273,2.91
1825,Hispanic,20,Trans*,1.41,FALSE,151,145,296,3.61
125,White,23,Male,3.17,FALSE,140,138,278,3.37
110,White,29,Female,3.18,TRUE,137,133,270,3.94
536,Native,20,Trans*,3.63,TRUE,138,164,302,3.5
0963,White,22,Female,2.46,FALSE,160,156,316,1.81
0866,Black,22,Male,3.86,FALSE,132,152,284,3.78
074,Hispanic,22,Trans*,2.12,TRUE,141,138,279,2.74
0924,White,30,Trans*,3.84,FALSE,142,153,295,2.61
646,White,29,Male,3.34,TRUE,144,134,278,2.88
686,Hispanic,24,Female,2.79,FALSE,167,143,310,3.58
393,Hispanic,27,Trans*,2.16,TRUE,162,137,299,2.44
1194,White,26,Female,3.51,FALSE,137,138,275,3.05
1801,White,29,Female,1.88,FALSE,140,167,307,2.07
182,White,20,Female,2.72,FALSE,140,131,271,3.63
375,White,21,Male,2.04,FALSE,137,134,271,3.75
0145,White,24,Female,2.41,FALSE,137,149,286,2.44
1823,Hispanic,29,Female,1.63,FALSE,155,160,315,3.93
0139,Hispanic,24,Female,3.62,FALSE,141,141,282,3.66
0259,White,23,Trans*,2.45,FALSE,167,155,322,3.23
556,Bi-Racial,27,Female,3.37,TRUE,140,131,271,3
410,White,26,Male,1.82,TRUE,151,132,283,3.5
0647,White,21,Trans*,3.51,FALSE,141,144,285,3.12
0433,Bi-Racial,24,Trans*,2.75,FALSE,150,137,287,3.55
587,White,25,Male,2.09,FALSE,166,139,305,3.05
414,White,20,Trans*,2.41,TRUE,160,138,298,3.16
084,Black,27,Trans*,2.15,FALSE,145,141,286,3.11
508,Black,22,Male,3.1,TRUE,164,142,306,2.99
784,White,24,Trans*,3.27,TRUE,131,134,265,3.87
1259,Hispanic,24,Trans*,1.94,FALSE,137,142,279,2.21
266,White,22,Female,2.96,FALSE,140,132,272,3.88
1038,White,27,Male,3.13,FALSE,153,151,304,3.42
0082,White,22,Trans*,3.44,FALSE,145,164,309,3.3
303,White,26,Trans*,1.58,FALSE,131,133,264,2.15
714,White,24,Male,2.36,TRUE,150,151,301,3.17
0246,White,24,Male,3.16,FALSE,152,163,315,3.68
108,Native,28,Male,2.27,FALSE,162,139,301,2.49
1530,Hispanic,25,Male,2.71,FALSE,135,160,295,2.76
1118,Native,29,Male,3.47,FALSE,163,139,302,2.81
0351,White,20,Trans*,3.96,FALSE,138,155,293,3.92
717,White,22,Trans*,3.61,TRUE,151,132,283,3.93
168,Bi-Racial,30,Trans*,3.2,FALSE,156,136,292,2.86
440,Hispanic,22,Trans*,1.25,FALSE,143,130,273,3.54
1746,Bi-Racial,20,Trans*,2.26,FALSE,170,146,316,2.98
306,Hispanic,27,Female,3.64,FALSE,163,141,304,3.18
1842,White,29,Male,3.02,FALSE,132,150,282,3.93
225,Black,20,Female,2.27,FALSE,130,134,264,3.96
1475,White,25,Trans*,1.76,FALSE,145,139,284,2.94
1364,White,20,Male,1.43,FALSE,134,167,301,2.47
1224,White,26,Female,1.95,FALSE,146,147,293,3.03
0802,Asian,28,Trans*,2.79,FALSE,140,155,295,3.53
218,Hispanic,28,Male,1.59,TRUE,162,134,296,3.16
0934,Hispanic,26,Female,1.84,FALSE,156,165,321,3.33
0405,White,20,Female,3.65,FALSE,148,135,283,3.07
267,White,23,Trans*,2.43,FALSE,145,132,277,2.86
783,White,23,Trans*,2.27,TRUE,146,141,287,3.25
350,Hispanic,30,Male,3.07,FALSE,138,135,273,3.5
129,White,26,Trans*,2.33,FALSE,157,145,302,2.45
1983,Hispanic,26,Trans*,3.83,FALSE,145,166,311,2.97
017,White,25,Female,2.31,TRUE,161,142,303,3.48
0295,White,27,Trans*,3.83,FALSE,144,133,277,3.41
314,White,24,Trans*,2.71,TRUE,154,138,292,3.04
1055,White,29,Trans*,3.71,FALSE,159,158,317,2.28
186,Black,27,Trans*,2.58,FALSE,146,131,277,2.81
1772,Bi-Racial,24,Male,1.55,FALSE,150,138,288,2.64
1824,White,25,Female,1.87,FALSE,130,140,270,3.27
1213,Hispanic,28,Female,2.5,FALSE,130,166,296,2.5
1594,Black,26,Male,2.84,FALSE,145,147,292,3.36
1299,White,20,Male,3.09,FALSE,146,141,287,3.45
056,Hispanic,21,Female,3.22,FALSE,141,142,283,3.04
543,Asian,27,Female,2.9,TRUE,142,132,274,2.93
0518,Hispanic,30,Trans*,3.66,FALSE,141,167,308,2.49
1040,White,23,Trans*,1.62,FALSE,161,161,322,2.86
137,Hispanic,30,Female,2.43,FALSE,166,131,297,2.72
512,Asian,26,Female,2.76,TRUE,164,130,294,3.26
0964,White,26,Female,2.62,FALSE,161,153,314,3.23
469,White,24,Male,2.67,FALSE,139,146,285,3.39
0084,Hispanic,20,Trans*,2.84,FALSE,162,166,328,3.17
1713,White,27,Female,3.37,FALSE,133,142,275,2.33
012,White,29,Female,2.31,TRUE,151,150,301,2.86
0649,Black,26,Male,3.94,FALSE,138,151,289,2.48
0391,White,22,Female,3.21,FALSE,144,133,277,3.11
0181,Hispanic,25,Male,3.27,FALSE,158,151,309,3.99
1870,White,27,Female,2.9,FALSE,142,160,302,3.76
017,White,28,Trans*,1.66,FALSE,141,130,271,3.01
015,White,22,Trans*,2.82,FALSE,158,137,295,3.41
0793,White,25,Female,1.97,FALSE,141,145,286,2.26
1016,White,28,Trans*,2.09,FALSE,138,169,307,2.75
1163,White,28,Female,1.83,FALSE,150,160,310,1.77
1293,Hispanic,26,Male,3.52,FALSE,153,158,311,3.23
1855,Hispanic,24,Male,2.86,FALSE,149,131,280,3.48
0791,Hispanic,25,Trans*,2.37,FALSE,157,162,319,3.02
1400,Asian,27,Trans*,2.17,FALSE,140,154,294,3.24
032,White,29,Female,2.28,TRUE,137,134,271,3.92
647,White,26,Trans*,2.52,FALSE,149,143,292,2.31
1937,White,24,Female,3.5,FALSE,152,149,301,3.28
175,White,26,Female,2.12,TRUE,131,138,269,3.36
1718,White,21,Male,3.91,FALSE,158,164,322,1.33
1622,Hispanic,22,Female,3.29,FALSE,134,148,282,3.63
0164,Hispanic,27,Trans*,2.2,FALSE,150,144,294,2.68
0707,Hispanic,29,Male,2.82,FALSE,149,167,316,2.14
094,White,22,Male,1.83,TRUE,141,141,282,2.95
343,Hispanic,22,Trans*,2.63,FALSE,143,134,277,3.32
1172,Hispanic,20,Female,2.58,FALSE,154,139,293,2.9
0485,White,25,Female,1.35,FALSE,140,153,293,3.98
066,Black,28,Female,2.55,FALSE,148,141,289,2.97
019,Black,27,Female,2.23,FALSE,142,153,295,2.36
0318,Native,28,Male,2.97,FALSE,139,137,276,3.86
045,Hispanic,24,Male,2.25,FALSE,135,136,271,2.7
552,White,22,Trans*,3.52,TRUE,139,131,270,3.3
1501,White,27,Female,1.18,FALSE,168,165,333,3.06
1366,White,25,Trans*,2.98,FALSE,163,149,312,3.26
1346,White,28,Male,3.31,FALSE,162,144,306,3.9
1447,White,23,Male,3.82,FALSE,147,147,294,3.44
0799,White,25,Trans*,2.32,FALSE,163,145,308,3.19
448,White,26,Male,2.39,FALSE,141,138,279,3.33
1577,Hispanic,24,Female,1.72,FALSE,157,131,288,3.35
090,Black,29,Male,2.76,FALSE,149,142,291,3.41
254,Bi-Racial,30,Female,3.03,FALSE,164,132,296,3.16
0577,Black,25,Female,3.48,FALSE,143,155,298,3.27
037,White,26,Trans*,2.36,TRUE,155,147,302,2.63
690,White,30,Male,2.45,TRUE,161,132,293,3.51
1329,White,29,Male,2,FALSE,157,135,292,2.7
273,White,22,Male,2.03,FALSE,144,132,276,2.86
0032,White,26,Female,2.29,FALSE,156,148,304,2.46
1560,White,21,Male,3.2,FALSE,147,157,304,2.68
0092,White,26,Trans*,2.93,FALSE,151,142,293,3.35
1469,Black,20,Trans*,3.62,FALSE,141,140,281,2.73
1482,Hispanic,23,Male,3.3,FALSE,141,144,285,2.8
1204,Hispanic,26,Male,2.89,FALSE,141,151,292,3.36
511,White,29,Trans*,1.63,TRUE,134,138,272,3.87
1946,White,22,Female,3.38,FALSE,164,154,318,2.28
0025,White,28,Female,2.96,FALSE,140,164,304,3.54
1641,White,28,Female,1.96,FALSE,153,132,285,2.58
0021,White,23,Female,3.82,FALSE,131,136,267,2.9
0214,White,22,Trans*,3.64,FALSE,142,165,307,3.91
1161,White,23,Male,1.55,FALSE,144,141,285,3.12
1001,White,25,Male,2.39,FALSE,149,140,289,2.16
0190,White,23,Male,2.09,FALSE,156,166,322,3.31
0676,White,26,Trans*,3.95,FALSE,151,153,304,2.35
1724,Black,30,Male,2.83,FALSE,140,158,298,3.26
662,Black,29,Male,2.56,FALSE,150,135,285,2.58
272,White,20,Female,1.71,FALSE,150,136,286,3.67
249,Asian,20,Female,3.01,TRUE,145,132,277,3.33
109,White,22,Male,1.93,FALSE,130,134,264,3.07
1753,White,28,Trans*,1.79,FALSE,165,156,321,1.39
495,Hispanic,22,Trans*,2.53,TRUE,133,131,264,3.01
1459,Hispanic,24,Female,2.68,FALSE,134,168,302,3.22
718,White,30,Female,2.49,FALSE,160,132,292,3.53
1275,Asian,24,Trans*,2.27,FALSE,152,165,317,2.4
1748,White,26,Trans*,2.83,FALSE,170,145,315,2.34
0881,White,23,Male,2.1,FALSE,150,130,280,3.72
0150,White,25,Female,2.76,FALSE,138,157,295,2.11
616,White,30,Trans*,2.86,TRUE,150,134,284,2.86
506,Black,27,Female,2.45,TRUE,158,135,293,3.26
063,White,26,Male,1.22,TRUE,146,136,282,3.39
722,Hispanic,24,Male,2.2,FALSE,140,138,278,3.51
0917,Asian,26,Trans*,2.47,FALSE,145,168,313,3.47
1255,White,24,Trans*,3.17,FALSE,158,150,308,3.78
096,White,21,Female,2.99,FALSE,145,146,291,3.11
0873,White,27,Trans*,3.95,FALSE,131,160,291,3.64
1407,Hispanic,27,Male,3.85,FALSE,148,146,294,2.39
172,White,20,Male,2.91,FALSE,132,130,262,3.37
1365,White,25,Male,3.48,FALSE,144,151,295,3.38
363,White,21,Trans*,2.4,TRUE,151,136,287,2.94
0346,White,28,Male,2.4,FALSE,132,131,263,1.57
0389,White,24,Male,2.52,FALSE,140,153,293,1.67
080,Hispanic,30,Female,2.11,TRUE,158,133,291,3.33
0321,White,24,Male,1.69,FALSE,138,154,292,3.7
531,White,27,Female,2.22,FALSE,148,147,295,3.54
355,Hispanic,25,Trans*,2.62,FALSE,134,131,265,2.88
0622,White,29,Male,2.21,FALSE,153,158,311,3.06
630,White,26,Male,2.41,TRUE,156,135,291,2.83
026,White,30,Male,2.42,FALSE,152,137,289,2.49
0804,Hispanic,28,Male,1.83,FALSE,151,133,284,3.76
611,White,24,Female,2.22,FALSE,148,137,285,2.85
0242,White,29,Male,1.97,FALSE,132,159,291,3.07
502,Hispanic,26,Trans*,2.11,FALSE,146,149,295,3.34
0533,White,29,Trans*,3.17,FALSE,145,152,297,3.5
1818,White,21,Male,3.27,FALSE,152,168,320,3.63
1420,White,24,Female,1.58,FALSE,148,166,314,3.89
480,White,26,Female,2.31,TRUE,165,131,296,3.34
0059,Hispanic,29,Female,2.16,FALSE,155,133,288,2.54
289,Hispanic,22,Male,2.29,FALSE,140,134,274,3.58
1770,Hispanic,30,Trans*,1.29,FALSE,151,141,292,2.55
623,White,25,Male,1.65,FALSE,145,134,279,2.99
386,White,29,Male,2.99,FALSE,148,134,282,2.36
0834,White,29,Female,3,FALSE,143,139,282,2.89
0810,White,28,Female,2.33,FALSE,162,137,299,3.28
0375,White,26,Male,2.87,FALSE,131,156,287,3.24
0328,Black,21,Female,2.13,FALSE,144,168,312,3.83
1277,White,24,Female,2.16,FALSE,144,146,290,3.2
1917,Hispanic,25,Trans*,2.96,FALSE,161,145,306,3.41
0208,White,29,Trans*,2.66,FALSE,150,166,316,3.64
1809,Hispanic,22,Male,1.05,FALSE,133,167,300,3.05
0915,White,24,Trans*,3.12,FALSE,156,168,324,3.22
1682,White,30,Female,2.13,FALSE,146,149,295,3.31
1727,White,29,Trans*,1.18,FALSE,159,161,320,3.83
072,Black,24,Female,2.18,TRUE,157,132,289,3.51
265,White,25,Male,2.26,TRUE,137,135,272,3.22
638,Black,30,Male,2.25,TRUE,148,130,278,3.57
227,White,22,Female,2.22,FALSE,142,133,275,2.65
0538,White,25,Trans*,2.38,FALSE,155,146,301,1.49
106,White,25,Male,2.04,TRUE,154,134,288,3.83
618,White,29,Trans*,2.98,FALSE,140,131,271,2.67
004,Asian,23,Male,2.38,FALSE,167,134,301,2.58
1382,Hispanic,30,Female,3.58,FALSE,158,164,322,3.4
0267,White,29,Trans*,1.37,FALSE,150,141,291,2.98
1827,White,20,Female,2.74,FALSE,145,166,311,2.79
568,White,24,Female,2.46,FALSE,150,141,291,3.69
1515,White,26,Female,1.18,FALSE,157,167,324,3.94
391,Hispanic,23,Female,2.51,TRUE,139,137,276,2.93
721,Black,26,Male,2.67,TRUE,139,136,275,3.2
063,White,22,Female,2.86,FALSE,139,131,270,3.48
750,Hispanic,23,Male,2.26,TRUE,157,134,291,3.13
0338,White,23,Male,1.46,FALSE,160,163,323,3.9
0283,Asian,30,Male,1.35,FALSE,140,146,286,2.97
565,White,26,Male,2.39,TRUE,169,142,311,2.65
1428,White,23,Male,1.01,FALSE,135,162,297,2.99
419,White,27,Male,2.56,TRUE,166,139,305,3.29
613,White,26,Male,2.57,FALSE,159,143,302,2.04
0383,White,20,Female,2.29,FALSE,146,131,277,3.36
1779,Asian,21,Trans*,2.12,FALSE,148,169,317,2.48
1648,Black,26,Trans*,3.79,FALSE,158,149,307,2.86
300,White,24,Female,2.42,FALSE,160,131,291,3.15
1012,White,21,Male,2.64,FALSE,155,159,314,3.79
0648,Hispanic,20,Female,2.93,FALSE,133,134,267,3.98
255,White,25,Female,3.64,TRUE,153,132,285,3.25
1684,Asian,24,Female,2.5,FALSE,152,170,322,2.75
1765,White,28,Female,2.16,FALSE,140,159,299,3.27
0608,White,30,Male,2.25,FALSE,152,146,298,2.85
608,White,28,Male,2.84,FALSE,162,143,305,2.98
292,White,22,Trans*,1.93,TRUE,139,144,283,3.91
0033,Black,24,Trans*,3.69,FALSE,153,156,309,3.68
1339,Black,26,Male,1.56,FALSE,157,153,310,3.79
1266,White,21,Female,1.83,FALSE,139,141,280,3.95
1590,Black,28,Male,2.42,FALSE,137,167,304,2.24
0984,Hispanic,20,Female,2.8,FALSE,139,149,288,2.31
0704,Black,27,Trans*,3.52,FALSE,151,133,284,2.61
081,Hispanic,21,Trans*,1.6,FALSE,169,149,318,2.68
1455,White,24,Female,1.25,FALSE,142,151,293,2.28
1391,White,23,Male,2.37,FALSE,145,162,307,3.72
0546,White,20,Female,2.4,FALSE,137,137,274,3.64
1220,White,23,Male,3.24,FALSE,145,165,310,3.03
0846,White,20,Female,2.23,FALSE,134,162,296,2.64
0152,White,25,Female,3.83,FALSE,138,147,285,3.58
281,White,25,Female,2.87,TRUE,139,141,280,3.26
274,Hispanic,21,Female,2.2,TRUE,164,139,303,2.59
408,White,26,Trans*,2.57,FALSE,152,132,284,3.43
1783,White,30,Female,2.23,FALSE,131,156,287,3.69
195,White,22,Male,2.06,FALSE,158,131,289,2.16
194,White,30,Male,2.07,FALSE,149,139,288,2.16
0051,White,28,Female,2.4,FALSE,152,160,312,1.61
655,White,25,Trans*,2.68,TRUE,137,133,270,3.22
1686,White,30,Female,3.37,FALSE,164,148,312,2.95
1792,White,23,Trans*,2.63,FALSE,139,163,302,3.96
681,White,23,Female,1.6,TRUE,159,141,300,3.01
0438,Black,20,Female,3.4,FALSE,148,165,313,3.94
1553,White,29,Female,1.77,FALSE,146,154,300,2.55
1754,White,27,Trans*,2.22,FALSE,137,138,275,2.16
1140,White,23,Male,2.77,FALSE,158,152,310,1.19
0250,White,20,Male,2.34,FALSE,159,132,291,2.88
0738,White,24,Trans*,2.31,FALSE,139,150,289,3.58
1667,Hispanic,29,Trans*,3.3,FALSE,140,152,292,3.69
0191,White,23,Male,1.28,FALSE,161,147,308,3.82
0919,Black,30,Female,3.44,FALSE,136,148,284,3.92
0097,White,21,Female,1.14,FALSE,136,138,274,2.01
1283,White,24,Female,1.78,FALSE,131,137,268,3.95
322,White,23,Trans*,3.11,FALSE,157,130,287,3.21
0910,Hispanic,29,Trans*,1.97,FALSE,142,155,297,2.4
1212,White,24,Female,1.93,FALSE,170,139,309,3.75
534,Hispanic,28,Female,1.32,TRUE,158,133,291,3.9
0361,White,20,Male,1.22,FALSE,151,133,284,3.51
554,White,24,Female,1.86,TRUE,148,134,282,3.85
1644,White,21,Male,1.49,FALSE,137,148,285,2.82
1956,White,21,Male,3.74,FALSE,151,155,306,3.71
0023,Native,28,Female,3.71,FALSE,157,157,314,3.74
659,White,22,Female,2.34,FALSE,138,138,276,2.58
1749,White,27,Female,2,FALSE,160,140,300,3.15
171,White,22,Female,2.3,FALSE,139,143,282,2.69
0230,Black,30,Male,2.18,FALSE,155,139,294,1.37
1077,Black,23,Female,1.73,FALSE,134,143,277,2.61
1287,Black,27,Trans*,1.07,FALSE,149,153,302,3.46
0529,White,25,Male,2.44,FALSE,163,167,330,1.83
586,White,20,Trans*,2.3,FALSE,140,135,275,3.33
422,Black,28,Trans*,2.4,TRUE,137,147,284,3.2
576,Hispanic,30,Male,1.33,FALSE,156,144,300,2.12
0540,White,28,Trans*,3.19,FALSE,155,140,295,2.78
222,Black,23,Trans*,2.5,FALSE,161,144,305,1.82
0047,White,20,Trans*,3.51,FALSE,140,159,299,2.68
1474,Black,29,Male,3.44,FALSE,133,168,301,3.15
0314,White,27,Male,3.29,FALSE,149,132,281,3.96
1815,Black,27,Female,3.99,FALSE,138,161,299,2.32
0324,Black,22,Trans*,3.85,FALSE,160,152,312,2.62
0417,White,25,Female,1.88,FALSE,152,148,300,2.77
1269,White,26,Trans*,3.97,FALSE,149,140,289,3.44
1773,Black,26,Female,2.41,FALSE,157,164,321,3.71
657,White,22,Male,2.58,FALSE,153,131,284,2.85
0615,Black,28,Male,1.72,FALSE,133,164,297,3.85
0655,White,30,Male,1.17,FALSE,155,168,323,2.89
1598,White,27,Male,2.95,FALSE,155,137,292,3.07
1640,Hispanic,20,Female,3.68,FALSE,136,160,296,3.74
604,White,27,Trans*,2.36,FALSE,141,133,274,2.51
724,White,28,Trans*,2.26,FALSE,149,142,291,3.02
131,Asian,25,Trans*,2.85,TRUE,160,135,295,3.63
781,Asian,24,Male,3.37,TRUE,155,131,286,2.79
1798,White,25,Trans*,2.39,FALSE,137,145,282,3.49
0241,White,29,Male,2.68,FALSE,164,159,323,1.97
1472,White,28,Female,2.26,FALSE,168,152,320,3.9
0909,White,26,Male,1.93,FALSE,144,142,286,3.39
132,White,24,Female,2.84,TRUE,140,134,274,2.81
463,White,28,Female,2.32,FALSE,153,139,292,2.77
1053,White,24,Male,3.1,FALSE,136,138,274,2.15
501,Hispanic,26,Male,3.17,TRUE,145,137,282,3.46
1938,White,20,Trans*,2.3,FALSE,142,156,298,3.53
1710,White,21,Female,2.61,FALSE,147,164,311,3.82
102,White,30,Trans*,2.7,FALSE,162,133,295,2.27
1817,Hispanic,20,Female,3.06,FALSE,148,152,300,3.94
731,Asian,25,Female,2.54,TRUE,143,131,274,3.23
345,White,22,Female,2.32,TRUE,134,137,271,3.95
365,White,22,Trans*,2.78,FALSE,134,145,279,2.63
439,Hispanic,28,Trans*,1.87,FALSE,139,133,272,2.54
770,White,21,Male,1.34,FALSE,135,136,271,3.23
478,White,29,Trans*,2.69,TRUE,137,134,271,3.49
591,Asian,20,Trans*,2.52,TRUE,167,133,300,3.68
563,White,26,Female,2.36,FALSE,150,141,291,3.1
490,White,22,Trans*,2.11,TRUE,142,140,282,3.39
558,White,23,Female,2.24,TRUE,161,130,291,3.91
509,Black,20,Male,2.23,FALSE,157,132,289,3.68
1276,White,20,Male,2.74,FALSE,148,132,280,3.21
1165,White,28,Trans*,3.49,FALSE,147,134,281,3.25
1850,White,22,Female,1.53,FALSE,134,164,298,2.61
291,Hispanic,25,Female,2.72,TRUE,143,140,283,2.99
481,White,21,Male,2.77,FALSE,149,139,288,2.94
0484,White,21,Male,2.82,FALSE,132,149,281,3.69
0428,White,23,Female,2.71,FALSE,135,148,283,1.08
1764,White,25,Female,3.42,FALSE,145,139,284,1.7
337,White,29,Trans*,2.02,TRUE,155,134,289,3.62
528,White,30,Female,3.9,TRUE,164,153,317,3.48
0183,White,25,Female,2.67,FALSE,134,153,287,3.91
075,White,26,Female,3.28,TRUE,134,136,270,3.55
0399,Hispanic,20,Male,3.6,FALSE,138,153,291,3.78
1394,Bi-Racial,25,Female,3.01,FALSE,136,138,274,3.2
0620,Hispanic,29,Male,2.8,FALSE,135,168,303,3.49
0565,Asian,26,Trans*,2.24,FALSE,153,152,305,3.7
1957,White,21,Male,3.63,FALSE,142,153,295,3.88
0291,White,28,Trans*,2.81,FALSE,164,158,322,3.46
302,Bi-Racial,29,Trans*,1.92,TRUE,132,138,270,3.53
0658,Black,22,Female,3.38,FALSE,165,157,322,3.43
659,White,28,Trans*,1.74,TRUE,134,131,265,3.57
613,White,23,Trans*,2.58,TRUE,156,131,287,3.12
268,White,22,Trans*,3.5,TRUE,148,141,289,2.48
1135,White,20,Trans*,2.2,FALSE,148,147,295,2.88
294,Asian,30,Trans*,2.96,FALSE,150,135,285,2.67
0404,Black,25,Female,1.9,FALSE,136,164,300,2.52
290,White,21,Trans*,1.78,FALSE,147,163,310,3.53
1901,White,21,Trans*,1.05,FALSE,136,163,299,2.52
1363,White,21,Trans*,3.96,FALSE,137,135,272,3.26
069,White,27,Trans*,2.06,TRUE,168,144,312,3.83
785,White,26,Trans*,2.81,TRUE,141,163,304,3.76
0056,White,26,Male,2.26,FALSE,137,156,293,3.06
359,White,25,Trans*,2.76,FALSE,146,130,276,2.62
0849,White,30,Trans*,2.54,FALSE,131,138,269,3.81
421,Hispanic,24,Male,2.06,TRUE,144,150,294,3.78
053,White,26,Female,2.34,FALSE,155,135,290,2.55
713,White,21,Trans*,3.01,FALSE,168,130,298,3.95
0863,White,27,Trans*,1.46,FALSE,154,135,289,3.28
1296,White,27,Trans*,1.41,FALSE,130,152,282,3.65
0490,White,24,Male,1.8,FALSE,132,152,284,2.96
0604,Hispanic,23,Trans*,3.84,FALSE,139,149,288,2.65
098,White,28,Female,3.15,FALSE,155,131,286,3.62
1354,Hispanic,29,Trans*,2.41,FALSE,163,163,326,2.32
550,Black,20,Female,2.08,FALSE,162,136,298,2.8
0721,Black,28,Trans*,2.08,FALSE,148,156,304,3.33
381,White,28,Trans*,2.31,FALSE,144,146,290,3.11
137,Black,28,Male,1.54,TRUE,157,145,302,2.99
571,White,25,Trans*,2.97,TRUE,160,137,297,3.49
1541,Hispanic,25,Female,2.26,FALSE,145,142,287,2.09
0180,White,26,Male,3.45,FALSE,131,156,287,3.84
1623,White,20,Trans*,2.88,FALSE,160,132,292,3.05
0153,White,30,Male,3.56,FALSE,145,166,311,3.66
251,White,26,Male,2.02,TRUE,143,136,279,3.99
455,Hispanic,24,Trans*,1.36,TRUE,146,131,277,2.82
1121,White,22,Male,3.16,FALSE,143,165,308,2.07
691,White,29,Male,2.74,FALSE,139,150,289,3.29
008,White,23,Female,3.64,FALSE,137,131,268,2.58
0138,White,25,Male,1.96,FALSE,160,162,322,3.47
136,Black,22,Trans*,2.33,FALSE,135,153,288,2.49
0668,Hispanic,29,Female,3.23,FALSE,145,135,280,3.93
583,White,21,Trans*,2.25,TRUE,151,146,297,2.85
0029,White,26,Male,1.13,FALSE,134,147,281,1.95
1703,White,20,Trans*,3.08,FALSE,141,134,275,3.73
432,Hispanic,23,Female,3.29,TRUE,152,137,289,2.6
636,Black,30,Trans*,2.59,TRUE,137,136,273,3.94
1136,White,26,Female,1.99,FALSE,169,147,316,1.97
328,White,23,Male,2.66,FALSE,164,139,303,1.76
1737,White,20,Trans*,2.43,FALSE,148,149,297,3.12
660,Hispanic,22,Male,3.57,FALSE,138,135,273,3.18
069,White,22,Trans*,3.05,FALSE,148,155,303,2.79
038,White,20,Trans*,2.91,TRUE,149,138,287,2.74
403,Hispanic,22,Male,2.43,TRUE,153,139,292,2.5
0584,Hispanic,30,Female,2.63,FALSE,161,136,297,2.17
498,White,26,Male,2.61,TRUE,155,142,297,3.58
381,White,21,Trans*,2.55,TRUE,143,142,285,2.64
0547,White,29,Trans*,2.43,FALSE,144,164,308,3.8
1886,White,28,Female,1.79,FALSE,161,136,297,3.1
0171,Black,28,Trans*,2.4,FALSE,144,156,300,3.85
0552,Hispanic,29,Male,3.35,FALSE,132,144,276,3.69
1889,Native,28,Female,3.37,FALSE,134,148,282,2.27
0440,Bi-Racial,30,Female,2.61,FALSE,139,133,272,3.69
712,Bi-Racial,21,Trans*,2.23,TRUE,161,137,298,2.58
0330,Hispanic,29,Male,1.97,FALSE,159,154,313,3.13
085,White,29,Male,1.94,TRUE,150,141,291,3.64
116,Black,21,Female,2.04,TRUE,140,136,276,3.6
524,White,30,Male,1.75,FALSE,139,145,284,3.27
0606,Black,21,Female,3.62,FALSE,140,150,290,3.25
058,Hispanic,24,Female,2.88,TRUE,139,134,273,3.93
437,White,29,Trans*,1.31,TRUE,152,139,291,3.9
0535,White,27,Male,3.12,FALSE,164,153,317,3.25
195,Black,23,Female,2.36,TRUE,136,136,272,2.58
429,White,29,Male,2.34,FALSE,153,141,294,2.46
1551,White,30,Male,2.84,FALSE,138,143,281,2.23
356,White,28,Female,2.26,FALSE,131,146,277,2.71
184,White,25,Trans*,2.32,TRUE,138,147,285,3.65
0962,Hispanic,22,Trans*,1.59,FALSE,157,140,297,2.75
582,White,28,Female,2.41,FALSE,162,132,294,1.84
0987,White,27,Male,3.07,FALSE,143,164,307,3.8
0705,Hispanic,30,Trans*,3.28,FALSE,153,169,322,3.09
425,White,25,Trans*,2.35,FALSE,134,137,271,2.08
254,White,20,Female,2.39,TRUE,139,140,279,3.08
243,White,21,Male,3.65,TRUE,142,132,274,2.95
1631,White,20,Male,2.71,FALSE,163,160,323,3.29
341,Asian,29,Female,3.74,TRUE,155,137,292,3.23
050,Asian,22,Trans*,1.84,FALSE,153,133,286,3.07
0131,White,24,Female,3,FALSE,148,168,316,2.08
1419,White,29,Male,3.85,FALSE,145,168,313,2.87
307,White,27,Trans*,2.25,TRUE,154,131,285,2.05
178,White,23,Female,1.93,FALSE,131,141,272,3.61
326,White,27,Female,2.97,FALSE,146,136,282,2.93
609,Black,24,Male,2.94,FALSE,155,134,289,2.6
1157,White,25,Trans*,3.62,FALSE,154,144,298,3.83
639,Black,27,Female,2,FALSE,137,131,268,3.09
1512,Hispanic,25,Trans*,1.52,FALSE,159,157,316,3.01
0530,White,30,Trans*,2.19,FALSE,143,152,295,2.42
0679,White,24,Male,2.1,FALSE,162,134,296,3.88
693,White,23,Male,2.07,FALSE,139,131,270,3.59
569,White,29,Female,3.35,TRUE,138,131,269,2.76
360,White,28,Female,2.58,FALSE,144,137,281,2.7
0211,White,29,Trans*,1.71,FALSE,131,133,264,3.98
1084,White,24,Female,3.03,FALSE,144,145,289,2.09
0073,White,22,Trans*,3.8,FALSE,132,166,298,3.05
1480,White,29,Female,2.56,FALSE,154,158,312,3.73
0498,White,28,Trans*,2.5,FALSE,144,149,293,1.44
054,Black,23,Male,3.31,FALSE,131,137,268,3.63
354,White,27,Female,2.75,FALSE,133,131,264,2.55
764,White,24,Female,2.89,FALSE,149,135,284,2.95
1089,Black,22,Trans*,3.9,FALSE,169,145,314,2.76
523,White,24,Trans*,2.22,FALSE,157,149,306,2.18
0671,White,26,Female,2.37,FALSE,131,168,299,3.94
675,Asian,27,Male,2.42,TRUE,157,134,291,3.21
0258,White,26,Trans*,2.86,FALSE,140,166,306,3.37
0270,Black,24,Female,1.86,FALSE,135,141,276,2.4
355,Hawaiian,22,Trans*,2.73,TRUE,157,133,290,3.16
0999,White,27,Trans*,3.05,FALSE,140,166,306,2.71
0858,White,25,Male,2.84,FALSE,147,136,283,3.33
054,White,21,Trans*,2.12,TRUE,153,134,287,2.98
607,Asian,25,Trans*,1.73,FALSE,169,145,314,2.82
0778,White,22,Female,3.39,FALSE,147,134,281,3.41
1139,White,29,Male,1.57,FALSE,138,148,286,1.18
313,White,23,Female,1.87,FALSE,159,136,295,1.93
1944,Hispanic,28,Male,2.21,FALSE,144,132,276,3.54
0298,Black,21,Trans*,2.59,FALSE,134,134,268,1.43
518,White,24,Male,2.36,FALSE,155,136,291,2.1
1249,White,23,Female,2.5,FALSE,142,160,302,3.83
0064,White,24,Female,3.66,FALSE,135,160,295,3.33
327,White,21,Male,1.58,TRUE,147,141,288,3.57
373,Black,24,Female,2.44,TRUE,135,133,268,3.45
505,Hispanic,22,Trans*,2.01,TRUE,135,130,265,2.51
0720,White,26,Male,2.51,FALSE,156,155,311,3.84
0560,White,22,Male,3.38,FALSE,144,138,282,3.6
1042,White,24,Female,1.77,FALSE,163,151,314,1.94
0280,Hispanic,29,Female,1.48,FALSE,163,146,309,3.97
581,Black,28,Male,2.79,FALSE,157,133,290,2.37
0219,Hispanic,30,Trans*,1.95,FALSE,163,158,321,3.77
0660,White,27,Trans*,1.68,FALSE,160,137,297,3.63
698,White,29,Male,2.62,TRUE,148,141,289,2.83
205,White,20,Trans*,2.02,TRUE,145,134,279,3.37
1254,White,22,Female,1.77,FALSE,165,165,330,2.69
514,White,25,Female,1.58,TRUE,164,151,315,3.34
0998,Asian,25,Trans*,1.83,FALSE,136,156,292,2.8
284,White,23,Female,1.86,FALSE,146,135,281,2.49
1044,Hispanic,24,Male,2.46,FALSE,139,147,286,3.26
0076,Black,27,Male,3.54,FALSE,140,153,293,3.16
343,White,28,Female,3.05,TRUE,144,140,284,3
758,Black,24,Female,2.84,FALSE,134,130,264,2.03
224,White,22,Male,2.51,FALSE,157,136,293,2.32
1922,Hispanic,29,Male,2.06,FALSE,147,141,288,3.15
0327,White,25,Female,2.19,FALSE,148,160,308,2
500,White,25,Trans*,1.68,FALSE,153,146,299,3.32
0497,White,21,Trans*,2.38,FALSE,134,159,293,3.54
0350,Black,20,Female,3.47,FALSE,146,147,293,2.36
181,White,20,Female,2.31,TRUE,154,138,292,3.31
397,White,22,Trans*,1.26,TRUE,145,131,276,3.16
110,White,20,Trans*,3.06,FALSE,134,134,268,3.17
1332,Hispanic,24,Male,2.66,FALSE,139,154,293,3.26
579,Bi-Racial,23,Female,2.6,FALSE,164,136,300,3.77
1129,Asian,22,Female,2.94,FALSE,161,134,295,3.91
161,White,26,Female,3.77,FALSE,147,141,288,2.91
1781,Black,23,Male,1.93,FALSE,136,158,294,3.02
0794,Asian,27,Male,1.65,FALSE,163,139,302,2.65
424,White,24,Trans*,2.13,TRUE,143,131,274,3.62
1452,White,26,Female,2.65,FALSE,154,136,290,3.48
1305,Black,26,Female,2.36,FALSE,152,134,286,3.79
1177,Hispanic,25,Male,2.14,FALSE,150,165,315,3.84
1808,Hispanic,26,Trans*,3.31,FALSE,147,147,294,1.94
1943,White,26,Male,1.28,FALSE,151,137,288,2.61
313,White,29,Male,2.3,TRUE,132,139,271,2.96
0752,White,21,Trans*,1.92,FALSE,141,142,283,2.32
0300,White,22,Female,2.76,FALSE,155,136,291,3.89
581,Black,24,Male,1.9,TRUE,132,136,268,3.98
315,White,30,Male,2.14,TRUE,155,141,296,3.77
521,Asian,27,Male,2.47,FALSE,142,134,276,2.02
0887,White,27,Male,3.95,FALSE,159,153,312,3.91
1144,White,29,Male,1.21,FALSE,138,158,296,3.78
779,White,30,Male,2.11,TRUE,160,135,295,3.63
0900,Bi-Racial,21,Male,2.96,FALSE,161,141,302,3.92
1073,White,23,Trans*,1.5,FALSE,137,143,280,2.96
640,Black,30,Female,2.83,FALSE,131,153,284,3.93
325,Hispanic,30,Male,2.09,FALSE,135,134,269,3.48
043,White,26,Male,2.47,TRUE,143,133,276,3.73
0764,Black,28,Female,2.37,FALSE,158,166,324,3.47
0709,Black,26,Male,3.06,FALSE,164,154,318,3.42
1743,White,23,Female,3.11,FALSE,134,133,267,3.95
1519,White,29,Female,2.11,FALSE,152,153,305,3.45
230,White,27,Female,2.13,FALSE,151,138,289,2.89
0362,Hispanic,20,Male,1.33,FALSE,133,154,287,2.29
340,White,28,Trans*,3.18,TRUE,132,134,266,3.58
763,White,28,Male,2.91,TRUE,150,140,290,3.29
1465,Hispanic,20,Male,2.9,FALSE,140,166,306,1.97
093,White,25,Male,2.98,TRUE,160,130,290,3.14
589,Asian,23,Trans*,2.89,TRUE,137,135,272,3.08
0562,Black,22,Male,3.33,FALSE,152,165,317,3.16
1043,Hispanic,26,Male,1.6,FALSE,135,159,294,3.6
0814,Asian,20,Female,3.56,FALSE,147,157,304,3.19
450,White,29,Trans*,2.28,TRUE,147,134,281,3.49
095,Bi-Racial,30,Female,2.44,FALSE,151,133,284,2.67
1583,White,22,Male,3.58,FALSE,157,134,291,2.24
664,White,27,Female,2.51,TRUE,148,144,292,3.2
1262,Hispanic,21,Male,2.76,FALSE,168,169,337,1.39
0723,Hispanic,21,Male,1.01,FALSE,151,133,284,2.97
1466,Bi-Racial,23,Trans*,3.04,FALSE,142,147,289,3.55
0959,Black,25,Female,3.49,FALSE,147,159,306,2.79
1722,White,24,Female,2.77,FALSE,138,162,300,3.62
772,Black,24,Male,1.34,TRUE,139,137,276,3.49
0039,White,25,Female,3.47,FALSE,155,169,324,3.42
1357,White,21,Trans*,2.88,FALSE,137,162,299,2.31
460,White,28,Female,2.4,TRUE,133,131,264,3.98
0166,White,21,Male,3.84,FALSE,141,152,293,3.24
683,White,25,Female,2.7,FALSE,140,134,274,2.85
429,White,30,Trans*,2.54,TRUE,155,136,291,3.04
1935,Asian,27,Trans*,2.77,FALSE,151,132,283,1.02
713,Bi-Racial,22,Trans*,2.8,TRUE,138,134,272,2.61
1949,White,27,Male,2.84,FALSE,147,158,305,3.75
0856,White,26,Trans*,2.17,FALSE,162,163,325,3.25
352,Hispanic,28,Trans*,2.04,TRUE,170,134,304,3.54
1493,White,23,Male,3.12,FALSE,136,145,281,3.78
561,White,25,Male,2.38,TRUE,153,137,290,2.16
394,Hispanic,20,Female,2.82,TRUE,152,131,283,3.53
552,Bi-Racial,20,Trans*,3.05,FALSE,145,131,276,2.96
1890,White,24,Trans*,1.3,FALSE,142,158,300,2.44
0103,Hispanic,29,Male,2.42,FALSE,150,136,286,3.2
630,White,27,Female,2.42,FALSE,144,132,276,3.45
1550,White,27,Female,3.68,FALSE,131,166,297,3.2
748,White,25,Trans*,2.71,FALSE,145,134,279,3.7
1761,White,26,Female,2.42,FALSE,163,144,307,3.38
1511,White,28,Female,1.05,FALSE,138,142,280,2.8
035,White,28,Female,3.04,TRUE,163,136,299,2.62
1843,White,26,Male,3.77,FALSE,132,166,298,2.53
1829,Hispanic,25,Male,2.25,FALSE,144,132,276,3.79
1181,White,22,Female,2.43,FALSE,137,140,277,3.97
199,White,24,Trans*,1.9,FALSE,139,133,272,2.83
1883,White,29,Male,3.43,FALSE,142,158,300,3.22
0093,White,26,Female,3,FALSE,148,153,301,2.86
210,Bi-Racial,20,Female,3.27,TRUE,155,130,285,3.6
0182,Asian,27,Male,2.6,FALSE,141,136,277,1.81
0754,White,22,Male,3.3,FALSE,159,152,311,2.98
0731,Hispanic,29,Male,1.09,FALSE,134,150,284,3.43
257,White,21,Trans*,2.47,TRUE,158,130,288,3.15
1578,White,20,Trans*,2.7,FALSE,147,140,287,2.85
561,White,24,Male,1.79,FALSE,153,139,292,3.29
0450,White,30,Male,3.22,FALSE,151,151,302,3.4
409,White,21,Female,2.38,TRUE,157,130,287,3.23
0503,Black,23,Female,2.65,FALSE,166,133,299,2.89
1793,White,29,Trans*,2.74,FALSE,160,146,306,2.31
0758,Hispanic,26,Female,1.11,FALSE,157,161,318,2.65
1126,Black,26,Trans*,2.61,FALSE,151,136,287,2.77
1508,White,22,Male,1.93,FALSE,133,165,298,1.12
1959,Hispanic,24,Trans*,3.25,FALSE,151,147,298,3.44
0776,White,28,Female,2.77,FALSE,141,132,273,3.47
585,White,21,Female,3.54,FALSE,135,133,268,2.27
1794,Hispanic,23,Female,2.18,FALSE,147,163,310,3.66
0030,White,23,Male,2.77,FALSE,162,166,328,3.87
0686,White,22,Trans*,2.65,FALSE,149,142,291,1.56
1834,Black,22,Trans*,3.33,FALSE,148,144,292,3.26
751,Black,25,Trans*,2.97,FALSE,142,141,283,3.69
0871,Black,23,Trans*,1,FALSE,138,163,301,3.92
1673,Asian,28,Female,2.47,FALSE,144,161,305,2.32
1054,White,27,Trans*,2.53,FALSE,142,160,302,3.19
1683,Asian,22,Male,2.79,FALSE,153,130,283,3.8
1127,Black,28,Male,2.01,FALSE,168,168,336,2.08
1699,White,27,Male,3.41,FALSE,153,162,315,2.48
0043,Black,22,Trans*,3.18,FALSE,141,132,273,3.96
1051,White,20,Trans*,3.32,FALSE,149,132,281,2.94
0222,White,22,Trans*,1.61,FALSE,149,138,287,3.81
0060,White,21,Male,1.84,FALSE,152,143,295,2.74
1632,Hispanic,25,Trans*,2.77,FALSE,141,149,290,2.64
658,White,30,Trans*,3.45,TRUE,151,141,292,2.6
070,White,20,Male,2.18,TRUE,131,143,274,3.35
0312,Asian,20,Female,1.37,FALSE,142,147,289,3.69
1015,Hispanic,25,Female,2.99,FALSE,135,133,268,2.69
214,White,27,Female,2.84,FALSE,155,135,290,2.01
1681,White,26,Male,1.66,FALSE,140,167,307,3.14
0257,White,23,Male,1.43,FALSE,150,139,289,2.99
1120,Black,21,Trans*,3.15,FALSE,160,159,319,3.94
0016,Black,20,Male,1.05,FALSE,133,156,289,2.83
1856,Hispanic,27,Male,3.45,FALSE,131,138,269,2.88
1473,White,27,Male,3.33,FALSE,163,169,332,3.18
580,White,30,Female,2.06,FALSE,141,134,275,2.14
0203,White,20,Female,3.61,FALSE,150,142,292,3.17
1805,White,24,Male,3.13,FALSE,136,146,282,3.72
582,White,22,Female,1.62,TRUE,162,132,294,2.94
376,Black,28,Trans*,2.65,FALSE,169,137,306,2.57
544,White,26,Male,1.79,TRUE,157,141,298,3.59
782,White,21,Trans*,3.21,FALSE,146,131,277,3.41
0836,Hispanic,23,Female,3.19,FALSE,156,161,317,3.73
316,White,28,Female,2.6,FALSE,155,135,290,2.7
729,White,21,Trans*,2.97,TRUE,166,145,311,3.01
1457,White,25,Female,2.75,FALSE,140,149,289,2.13
446,White,24,Trans*,2.22,TRUE,147,135,282,3.15
0385,Asian,29,Male,2.73,FALSE,143,151,294,3.63
756,Black,30,Female,2.25,TRUE,154,133,287,3.96
0313,White,27,Male,1.67,FALSE,162,142,304,2.08
0937,White,25,Male,2.33,FALSE,158,134,292,3.95
238,Black,22,Female,2.67,FALSE,145,137,282,2.88
514,White,23,Male,1.97,FALSE,152,137,289,3.54
0437,White,30,Female,2.81,FALSE,133,163,296,3.14
204,Hispanic,28,Trans*,1.71,TRUE,152,143,295,3.64
0528,White,20,Trans*,3.78,FALSE,139,140,279,3.44
1690,Hispanic,20,Trans*,1.78,FALSE,133,155,288,2.28
031,White,25,Trans*,2.32,FALSE,151,139,290,2.95
1939,White,23,Trans*,2.8,FALSE,133,168,301,3.68
0973,White,20,Trans*,1.66,FALSE,132,132,264,3.38
0601,White,21,Trans*,2.21,FALSE,155,169,324,3.66
092,White,23,Male,1.71,FALSE,154,147,301,2.9
619,Hispanic,24,Trans*,2.9,TRUE,157,130,287,3.47
1326,White,30,Male,2.57,FALSE,137,141,278,3.52
1693,White,29,Trans*,3.39,FALSE,139,149,288,3.24
594,Hispanic,25,Trans*,2.52,FALSE,155,145,300,2.09
1424,Hispanic,28,Male,3,FALSE,133,138,271,3.82
1211,White,28,Trans*,1.46,FALSE,165,154,319,3.96
0902,White,22,Trans*,3.43,FALSE,152,154,306,3.53
0545,Hispanic,28,Female,3.86,FALSE,145,159,304,3.98
0268,White,21,Male,2.68,FALSE,157,142,299,3.15
154,White,28,Male,2.68,FALSE,146,132,278,2.98
0263,Black,20,Male,2.46,FALSE,157,169,326,2.72
1914,White,30,Female,2.2,FALSE,137,160,297,3.01
093,Black,27,Trans*,3.34,FALSE,144,134,278,2.02
1334,White,30,Female,2.06,FALSE,145,137,282,2.96
145,Hispanic,22,Male,2.51,FALSE,137,133,270,3.15
1405,White,29,Trans*,2.73,FALSE,142,145,287,3.43
1964,White,26,Female,2.95,FALSE,137,156,293,3.65
285,White,27,Female,1.93,FALSE,154,141,295,2.86
1634,Hispanic,23,Male,2.9,FALSE,159,147,306,2.72
496,White,29,Male,2.67,TRUE,142,130,272,3.63
325,White,29,Trans*,2.5,TRUE,157,131,288,3.57
1002,White,29,Male,1.76,FALSE,147,155,302,3.16
0806,White,27,Trans*,1.86,FALSE,163,131,294,1.72
1315,Hispanic,25,Female,3.42,FALSE,153,158,311,3.43
1412,Other,20,Trans*,2.25,FALSE,135,139,274,2.43
782,White,29,Trans*,3.3,TRUE,153,150,303,2.96
631,Hispanic,28,Female,1.78,FALSE,133,142,275,2.99
0730,White,21,Female,1.98,FALSE,130,156,286,1.75
0859,Black,20,Male,3.06,FALSE,141,147,288,3.17
1351,Black,20,Trans*,2.41,FALSE,159,155,314,2.79
0007,White,22,Trans*,2.89,FALSE,146,160,306,1.84
166,White,22,Trans*,3.34,TRUE,155,133,288,3.04
1853,White,29,Female,2.21,FALSE,147,132,279,3.74
1942,White,30,Male,3.33,FALSE,138,150,288,2.45
0642,White,25,Female,3.43,FALSE,154,141,295,2.06
437,Hispanic,28,Female,2.41,FALSE,134,141,275,2.86
380,Hispanic,30,Female,3.28,TRUE,160,138,298,2.25
0641,Black,21,Female,2.82,FALSE,166,145,311,3.72
1885,Asian,20,Male,2.72,FALSE,156,162,318,3.97
0392,White,23,Trans*,2.34,FALSE,148,141,289,2.8
0536,White,30,Trans*,2.83,FALSE,137,159,296,3.74
684,White,24,Male,2.17,TRUE,144,144,288,2.5
0582,White,29,Male,3.07,FALSE,161,166,327,3.72
0290,White,27,Trans*,1.03,FALSE,142,157,299,3.57
0760,White,30,Trans*,3.87,FALSE,144,163,307,3.6
082,White,29,Trans*,3.39,TRUE,163,134,297,3.33
1776,Hispanic,21,Male,2.78,FALSE,157,131,288,3.8
546,Black,26,Female,1.77,FALSE,150,131,281,3.57
1638,White,28,Male,2.01,FALSE,156,166,322,3.35
068,White,28,Female,1.95,TRUE,151,135,286,2.53
522,Hispanic,20,Trans*,2.34,FALSE,142,130,272,2.56
539,Black,21,Male,2.63,FALSE,139,134,273,3.18
1897,White,30,Female,3.12,FALSE,165,147,312,3.76
1291,White,24,Trans*,2.35,FALSE,148,166,314,3.4
452,White,27,Trans*,2.29,FALSE,165,143,308,3.81
1967,White,28,Female,3.68,FALSE,132,153,285,3.86
0406,Black,23,Male,1.52,FALSE,155,142,297,3.66
1696,White,21,Female,3.54,FALSE,151,144,295,2.88
1580,White,25,Female,1.88,FALSE,152,167,319,2.49
0352,Hispanic,24,Female,2.15,FALSE,156,160,316,3.93
301,White,26,Male,3.52,TRUE,149,131,280,3.42
510,Black,30,Female,3.23,FALSE,148,137,285,2.84
1297,Hispanic,30,Trans*,1.56,FALSE,135,155,290,2.58
751,White,30,Male,2.49,TRUE,144,130,274,2.31
0742,White,27,Trans*,1.34,FALSE,147,153,300,2.24
458,Hispanic,23,Male,2.85,FALSE,166,138,304,2.46
1372,Hispanic,27,Trans*,2.99,FALSE,154,155,309,2.56
0382,Hispanic,23,Trans*,3.36,FALSE,138,155,293,3.81
336,White,28,Male,2.27,FALSE,142,131,273,3.13
0373,Asian,28,Trans*,3.86,FALSE,134,170,304,3.38
1861,Asian,24,Trans*,1.17,FALSE,149,154,303,3.85
474,White,21,Trans*,3.25,FALSE,150,144,294,2.75
488,Asian,22,Trans*,1.95,FALSE,150,137,287,3.29
0800,Hispanic,21,Female,1.69,FALSE,141,149,290,2.26
321,White,21,Female,3.06,FALSE,136,134,270,2.87
1587,White,25,Trans*,2.73,FALSE,131,138,269,2.56
748,Hispanic,30,Female,2.69,TRUE,151,153,304,3.03
257,Asian,22,Male,2.62,FALSE,146,133,279,3.03
445,White,22,Male,2.41,FALSE,163,132,295,3.18
1238,White,23,Male,3.75,FALSE,149,151,300,3.89
0387,White,20,Female,1.95,FALSE,167,167,334,2.07
489,Hispanic,22,Female,2.48,TRUE,151,141,292,2.64
1429,Black,23,Trans*,1.38,FALSE,132,145,277,1.9
1816,White,24,Trans*,1.33,FALSE,162,140,302,3.33
1467,White,23,Male,2.66,FALSE,146,167,313,2.6
1431,Hispanic,24,Female,3.97,FALSE,132,140,272,3
1760,Hispanic,29,Male,3.18,FALSE,149,134,283,3.59
282,White,30,Female,2.4,TRUE,140,144,284,2.57
0431,Hispanic,20,Male,1.4,FALSE,165,146,311,2.02
1669,White,22,Male,2.77,FALSE,137,156,293,1.63
1618,Bi-Racial,29,Female,1.94,FALSE,153,163,316,2.08
0055,White,23,Female,2.46,FALSE,151,148,299,3.02
555,White,30,Trans*,2.05,FALSE,143,148,291,2.9
0413,Hispanic,29,Trans*,1.76,FALSE,148,160,308,3.64
1521,White,30,Male,1.78,FALSE,160,150,310,2.99
1453,White,23,Male,2.71,FALSE,148,146,294,3.1
1147,Black,27,Female,2.66,FALSE,161,144,305,2.16
293,Hispanic,22,Male,2.76,FALSE,153,134,287,3.87
1218,Hispanic,30,Male,2.17,FALSE,157,145,302,2.39
0631,Black,27,Male,1.58,FALSE,151,154,305,3.16
1383,White,30,Male,3.59,FALSE,140,164,304,3.39
687,White,30,Trans*,2.24,FALSE,131,145,276,2.61
1844,White,24,Trans*,3.88,FALSE,161,136,297,3.45
517,White,29,Female,2.65,TRUE,132,146,278,3.19
0265,Hispanic,20,Trans*,1.18,FALSE,148,137,285,3.16
369,Black,27,Trans*,3.43,TRUE,138,133,271,2.88
743,White,30,Trans*,1.59,TRUE,140,141,281,3.69
024,White,22,Male,2.97,TRUE,134,139,273,2.98
173,White,25,Female,3.12,FALSE,150,140,290,3.52
0264,White,21,Male,1.74,FALSE,132,166,298,3.37
0541,Black,21,Trans*,1.22,FALSE,136,163,299,2.24
1807,White,24,Male,1.91,FALSE,165,165,330,3.9
536,Bi-Racial,24,Male,2.91,FALSE,164,133,297,3.09
025,Black,26,Trans*,1.46,FALSE,156,140,296,3.28
485,White,29,Female,3.64,FALSE,143,140,283,3.55
0822,White,24,Male,2.63,FALSE,143,139,282,3.08
0544,Hawaiian,30,Trans*,2.48,FALSE,161,170,331,3.25
228,Hispanic,27,Female,2.48,FALSE,141,145,286,1.99
1864,White,24,Female,1.71,FALSE,146,158,304,1.96
431,Hispanic,24,Trans*,2.64,TRUE,146,135,281,3.25
103,White,30,Trans*,3.22,TRUE,164,145,309,3.63
191,White,27,Trans*,2.25,FALSE,156,136,292,3.33
0204,Hispanic,25,Male,1.85,FALSE,146,133,279,3.65
0926,White,27,Female,2.59,FALSE,133,141,274,3.03
728,White,30,Male,2.13,TRUE,161,151,312,3.5
0522,Hawaiian,30,Male,1.64,FALSE,143,162,305,3.33
0609,White,25,Female,1.8,FALSE,135,158,293,3.3
1931,White,24,Female,3.92,FALSE,137,162,299,2.82
158,Hawaiian,21,Female,2.37,TRUE,153,141,294,3.69
160,White,27,Trans*,3.09,FALSE,165,130,295,3.17
1368,Black,29,Female,2.17,FALSE,160,160,320,1.81
148,White,30,Female,2.71,TRUE,138,135,273,3.88
293,Asian,27,Male,3.01,TRUE,148,135,283,2.92
700,Hispanic,24,Trans*,2.7,TRUE,164,131,295,3.7
0090,Hispanic,20,Trans*,3.2,FALSE,156,144,300,3.35
235,White,26,Trans*,2.32,TRUE,156,135,291,2.88
0563,White,28,Trans*,2.67,FALSE,131,138,269,3.49
255,White,21,Trans*,1.97,FALSE,144,132,276,3.63
633,White,24,Female,2.62,FALSE,150,133,283,2.83
461,White,20,Trans*,3.4,TRUE,143,132,275,2.76
0848,White,28,Trans*,2.08,FALSE,163,151,314,2.77
213,White,22,Female,3.06,TRUE,138,130,268,3.17
0159,White,24,Trans*,1.92,FALSE,147,149,296,2.17
1264,White,24,Female,2.61,FALSE,159,141,300,2.91
0967,White,25,Trans*,2.53,FALSE,144,133,277,3.66
0068,White,25,Male,1.13,FALSE,142,153,295,2.49
662,Asian,20,Trans*,3.03,TRUE,151,132,283,2.97
467,White,24,Trans*,1.94,TRUE,156,134,290,3.34
222,White,28,Trans*,2.26,TRUE,155,131,286,3.91
0388,White,25,Female,2.42,FALSE,155,150,305,2.67
736,Hispanic,23,Male,2.84,TRUE,148,137,285,3.46
0353,White,28,Female,2.12,FALSE,146,169,315,3.4
0824,Black,27,Trans*,3.57,FALSE,160,134,294,3.88
348,White,25,Trans*,1.93,FALSE,155,134,289,3.33
1205,White,26,Male,3.85,FALSE,141,142,283,1.96
1403,White,21,Female,2.84,FALSE,134,161,295,3
1679,Bi-Racial,27,Male,2.76,FALSE,158,150,308,2.96
1352,Hispanic,29,Trans*,2.09,FALSE,143,148,291,3.41
070,Hispanic,21,Female,2.78,FALSE,146,142,288,2.91
584,White,26,Male,2.29,TRUE,150,134,284,3.41
0969,Hispanic,23,Male,1.27,FALSE,146,163,309,3.46
235,Asian,22,Male,3.38,FALSE,137,134,271,2.47
1200,White,24,Male,3.65,FALSE,140,134,274,3.39
0038,White,26,Male,2.89,FALSE,146,136,282,3.41
1570,White,26,Trans*,1.52,FALSE,130,167,297,3.77
577,Black,30,Male,2.57,FALSE,135,143,278,3.4
0766,Black,20,Trans*,3.93,FALSE,141,146,287,3.32
0035,White,21,Female,1.92,FALSE,150,160,310,2.84
1175,Asian,23,Trans*,3.25,FALSE,158,135,293,2.34
209,White,26,Trans*,2.25,FALSE,134,143,277,3.66
1745,Hispanic,30,Female,3.24,FALSE,157,159,316,3.83
1984,Hispanic,26,Trans*,1.44,FALSE,154,167,321,3.77
159,Native,27,Trans*,3,FALSE,157,134,291,2.7
0895,White,22,Female,3.33,FALSE,150,130,280,2.82
1285,Asian,22,Trans*,2.32,FALSE,133,151,284,3.7
401,Hispanic,21,Trans*,2.29,TRUE,140,136,276,2.83
251,White,25,Trans*,2.36,FALSE,144,148,292,3.17
406,White,25,Female,2.3,FALSE,146,139,285,2.24
1191,White,30,Female,2.22,FALSE,150,159,309,2.82
485,White,22,Trans*,2.63,TRUE,137,145,282,2.55
0459,White,28,Male,2.22,FALSE,139,142,281,1.96
0114,Black,29,Female,1.99,FALSE,136,153,289,2.42
335,White,24,Female,2.48,FALSE,163,142,305,3.93
1274,Hispanic,30,Female,3.22,FALSE,166,131,297,3.61
440,White,24,Female,2.55,TRUE,161,133,294,3.35
1024,Hispanic,23,Female,1.11,FALSE,169,162,331,2.47
0147,White,21,Trans*,2.4,FALSE,154,149,303,2.79
1968,White,23,Trans*,3.03,FALSE,135,158,293,3.12
0531,White,20,Male,2.77,FALSE,148,163,311,3.08
1050,White,20,Trans*,3.11,FALSE,147,159,306,1.92
0216,White,30,Male,2.76,FALSE,131,157,288,3.17
0069,White,23,Trans*,1.45,FALSE,150,136,286,3.19
111,Asian,26,Female,2.26,FALSE,138,132,270,2.94
1476,White,24,Male,1.17,FALSE,140,133,273,3.36
261,Black,21,Trans*,2.77,TRUE,147,140,287,3.58
1741,White,24,Female,1.53,FALSE,142,165,307,3.47
0439,Hispanic,25,Female,1.96,FALSE,131,161,292,2.05
1322,Black,25,Trans*,3,FALSE,151,144,295,3.36
0378,Hispanic,29,Female,3.06,FALSE,132,166,298,3.26
1923,White,21,Male,3.31,FALSE,132,147,279,2.88
545,White,30,Male,2.67,FALSE,158,130,288,2.25
1495,White,20,Male,1.51,FALSE,136,150,286,3.54
339,Asian,23,Male,2.59,TRUE,168,136,304,3.53
058,White,20,Male,1.95,FALSE,155,133,288,3.19
405,White,24,Trans*,3.06,TRUE,148,140,288,3.54
1048,White,30,Male,1.68,FALSE,133,160,293,3.86
048,White,24,Male,2.52,FALSE,139,142,281,3.47
0878,White,23,Male,1.93,FALSE,158,164,322,3.11
329,Hispanic,20,Male,1.34,TRUE,133,136,269,2.53
1478,White,30,Male,2.29,FALSE,152,156,308,2.86
1615,White,25,Male,2.31,FALSE,138,157,295,3.79
624,Black,20,Trans*,3.28,TRUE,156,133,289,3.28
639,White,25,Trans*,1.8,TRUE,159,132,291,2.91
1193,White,23,Male,2.84,FALSE,135,162,297,2.89
007,White,29,Female,2.99,FALSE,132,131,263,2.52
721,Black,28,Female,3.02,FALSE,159,139,298,2.58
1919,White,29,Female,1.58,FALSE,161,170,331,1.63
604,White,30,Female,2.15,TRUE,161,136,297,3.51
0426,White,23,Female,2.67,FALSE,162,153,315,3.89
1642,White,20,Male,1.14,FALSE,137,165,302,3.47
0708,Asian,24,Trans*,1.6,FALSE,135,159,294,2.65
0877,White,20,Male,2.97,FALSE,135,155,290,2.46
0463,White,25,Female,3.63,FALSE,152,137,289,2.83
491,White,25,Male,2.26,TRUE,157,156,313,3.27
708,Hispanic,27,Female,2.04,TRUE,156,137,293,3.54
0779,White,29,Female,3.12,FALSE,136,153,289,3.38
599,White,23,Female,3.06,TRUE,146,140,286,3.21
1243,Hispanic,22,Male,2.46,FALSE,132,152,284,3.71
444,White,27,Male,1.98,FALSE,143,134,277,2.99
0896,Hispanic,28,Male,3.68,FALSE,153,135,288,2.75
0993,White,24,Trans*,1.58,FALSE,163,164,327,3.69
638,Hispanic,26,Trans*,1.52,FALSE,163,141,304,3.15
679,White,30,Female,2.04,TRUE,155,161,316,3.1
0044,Black,29,Male,2.88,FALSE,165,133,298,2.41
0360,Hispanic,26,Male,3.95,FALSE,144,165,309,3.12
1046,White,30,Trans*,3.12,FALSE,165,163,328,3.64
635,Asian,22,Male,2.63,TRUE,145,132,277,3.82
258,White,22,Male,2.09,TRUE,144,131,275,3.83
1738,White,30,Female,3.61,FALSE,160,163,323,3.3
006,White,27,Male,2.11,FALSE,132,137,269,2.87
544,White,25,Trans*,2.53,FALSE,136,133,269,3.13
1071,Black,29,Trans*,3.43,FALSE,167,139,306,3.3
0065,White,23,Trans*,2.32,FALSE,154,169,323,2.6
1951,White,25,Trans*,1.86,FALSE,158,161,319,3.73
384,White,23,Female,2.94,FALSE,163,135,298,3.74
0207,White,20,Trans*,3.83,FALSE,149,143,292,1.69
269,White,28,Female,3.01,FALSE,140,134,274,2.99
0315,White,25,Male,1.26,FALSE,149,136,285,3.95
0335,White,23,Female,2.52,FALSE,137,136,273,2.8
189,White,28,Trans*,2.17,TRUE,142,132,274,3.44
411,Hispanic,28,Trans*,2.81,TRUE,138,143,281,2.7
101,White,23,Female,1.91,FALSE,154,145,299,2.41
0610,Hispanic,22,Trans*,1.76,FALSE,153,135,288,2.93
156,Hispanic,21,Trans*,2.6,FALSE,149,134,283,3.63
418,Hispanic,26,Female,2.9,TRUE,160,146,306,3.44
1928,White,21,Female,3.48,FALSE,136,146,282,1.56
410,Hispanic,24,Male,3.19,FALSE,131,140,271,2.92
1936,White,27,Female,1.72,FALSE,156,164,320,3.06
0692,White,26,Female,1.56,FALSE,165,133,298,2.62
1423,White,26,Trans*,2.95,FALSE,138,168,306,3.44
1397,Black,24,Female,2.17,FALSE,150,130,280,2.63
395,White,22,Male,1.86,TRUE,136,139,275,3.77
0949,White,20,Male,1.5,FALSE,146,159,305,2.23
0940,White,23,Male,2.73,FALSE,143,160,303,3.18
0750,White,27,Female,1.77,FALSE,157,132,289,1.38
532,White,30,Male,2.61,TRUE,141,131,272,3.23
201,Hispanic,30,Female,2.41,TRUE,144,140,284,3.41
1513,Black,22,Female,1.73,FALSE,146,135,281,3.19
1427,White,27,Trans*,2.53,FALSE,141,142,283,2.75
1176,Bi-Racial,30,Female,1.91,FALSE,136,147,283,2.93
0659,White,29,Trans*,3.25,FALSE,163,130,293,3.48
1787,Asian,30,Trans*,3.47,FALSE,147,161,308,3.86
0852,White,28,Male,2.65,FALSE,131,141,272,3
001,White,30,Female,2.4,TRUE,165,142,307,3.13
1572,White,24,Trans*,3.85,FALSE,142,167,309,3.1
459,White,22,Trans*,2.17,TRUE,155,131,286,2.65
1308,White,25,Female,2.68,FALSE,162,151,313,3.24
1150,Black,30,Trans*,1.29,FALSE,156,164,320,3.55
253,White,30,Female,3.07,FALSE,150,132,282,3.32
1628,Hispanic,30,Male,2.59,FALSE,163,146,309,2.57
376,White,27,Female,3.4,TRUE,143,150,293,3.06
0694,White,27,Trans*,2.62,FALSE,133,167,300,3.3
693,White,22,Trans*,2.35,TRUE,168,147,315,3.25
1758,Black,26,Male,2.46,FALSE,156,147,303,3.57
281,Hispanic,21,Trans*,2.8,FALSE,132,140,272,2.87
0184,White,22,Male,2.67,FALSE,133,167,300,2.94
772,White,28,Trans*,2.53,FALSE,140,131,271,2.4
0499,White,30,Male,2.78,FALSE,149,146,295,3.74
089,Hispanic,23,Female,2.87,FALSE,154,134,288,2.62
0154,White,21,Female,1.44,FALSE,160,152,312,3.62
0122,White,21,Male,3.37,FALSE,144,153,297,3.75
0674,Hispanic,27,Male,3.2,FALSE,142,168,310,3.1
244,White,28,Male,2.16,FALSE,135,134,269,2.79
507,Hispanic,25,Female,3.5,FALSE,159,146,305,2.37
1436,Hispanic,29,Female,2.1,FALSE,132,169,301,2.02
636,White,20,Male,1.81,FALSE,142,138,280,2.83
0927,Hispanic,28,Trans*,1.96,FALSE,150,158,308,2.58
403,White,27,Female,2.83,FALSE,167,134,301,3.17
0225,Black,24,Female,2.55,FALSE,141,136,277,2.7
1019,Black,21,Male,2.41,FALSE,134,147,281,2.39
702,Hispanic,24,Trans*,2.78,FALSE,169,132,301,3.29
538,White,27,Female,3.56,FALSE,145,134,279,3.39
260,White,24,Male,3.2,TRUE,139,138,277,3.75
1859,White,20,Trans*,2.47,FALSE,140,153,293,2.88
0468,White,28,Female,2.47,FALSE,167,151,318,1.78
1767,White,25,Male,1.75,FALSE,145,160,305,2.18
040,White,26,Female,2.79,FALSE,159,139,298,3.66
1795,White,20,Trans*,2.61,FALSE,157,169,326,2.67
641,White,25,Female,1.98,TRUE,135,134,269,3.44
1345,Asian,25,Male,2.55,FALSE,149,165,314,3.82
0009,Black,23,Trans*,2.96,FALSE,146,150,296,3.87
688,White,23,Female,2.71,FALSE,144,150,294,2.39
0985,White,21,Trans*,3.36,FALSE,155,167,322,3.07
150,White,25,Female,1.95,TRUE,157,135,292,3.27
0252,White,28,Female,1.89,FALSE,152,153,305,3.94
1941,White,26,Male,2.48,FALSE,157,167,324,2.55
579,White,30,Female,2.12,TRUE,133,135,268,3.35
1244,White,20,Female,1.64,FALSE,135,147,282,3.37
0488,White,21,Female,2.61,FALSE,137,159,296,2.77
779,Bi-Racial,22,Trans*,2.15,FALSE,154,158,312,3.29
212,White,27,Trans*,2.78,FALSE,153,133,286,3.86
1225,Black,21,Female,2.86,FALSE,134,145,279,3.93
1680,White,21,Trans*,3.52,FALSE,159,166,325,2.34
353,White,27,Female,2.44,TRUE,153,132,285,3.05
538,Hispanic,22,Female,1.79,TRUE,158,146,304,3.15
661,White,29,Trans*,2.92,FALSE,157,136,293,2.16
263,White,27,Male,2.49,TRUE,159,130,289,3.26
1732,White,20,Male,3.69,FALSE,137,140,277,3.3
1483,White,27,Male,1.26,FALSE,148,157,305,3.23
0585,White,21,Male,3.27,FALSE,143,149,292,3.85
1237,Black,20,Trans*,2.09,FALSE,136,145,281,2.98
0514,White,26,Female,1.1,FALSE,148,166,314,2.46
237,Hispanic,28,Female,1.85,TRUE,158,143,301,2.81
1902,White,27,Female,2.57,FALSE,139,141,280,2.99
0390,White,23,Male,1.99,FALSE,138,141,279,3.55
1413,White,24,Trans*,1.46,FALSE,152,156,308,2.66
0125,Hispanic,22,Male,2.59,FALSE,142,154,296,2.68
081,Asian,28,Trans*,2.29,TRUE,136,130,266,3.91
1505,Hispanic,21,Female,3.14,FALSE,166,153,319,3.6
455,Asian,27,Female,2.23,FALSE,144,138,282,2.81
569,Hispanic,21,Male,2.21,FALSE,148,133,281,3.67
0638,Black,22,Trans*,3.28,FALSE,133,168,301,2.99
0363,White,26,Male,2.13,FALSE,136,148,284,3.42
1080,White,28,Male,2.79,FALSE,141,151,292,1.86
788,White,20,Female,1.73,TRUE,140,145,285,3.52
1445,White,27,Trans*,3.62,FALSE,134,135,269,3.25
1152,White,22,Female,3.07,FALSE,154,150,304,1.49
0556,White,23,Trans*,2.59,FALSE,166,169,335,3.33
087,White,26,Female,2.7,TRUE,145,132,277,3.23
134,White,22,Trans*,2.87,TRUE,165,148,313,3.65
1960,White,27,Male,2.81,FALSE,134,166,300,3.13
434,Asian,30,Trans*,3.07,TRUE,147,136,283,3.58
0947,White,23,Female,3.58,FALSE,135,155,290,3.61
1379,Black,20,Female,1.66,FALSE,155,159,314,2.19
711,White,25,Female,1.94,FALSE,163,150,313,2.4
1319,Black,21,Male,3.98,FALSE,130,161,291,3.16
0599,Asian,26,Female,1.67,FALSE,143,148,291,3.66
074,Hispanic,21,Female,2.6,FALSE,140,138,278,3.08
1862,White,22,Female,3.05,FALSE,137,143,280,3.59
134,White,30,Female,2.16,FALSE,147,136,283,2.66
672,White,21,Female,2.47,FALSE,151,155,306,3.3
692,White,28,Male,2.43,TRUE,163,151,314,3.87
769,Hispanic,21,Female,2.75,TRUE,167,135,302,3.62
698,Black,28,Male,2.14,FALSE,153,139,292,2.46
0696,White,27,Trans*,2.54,FALSE,148,168,316,2.01
0665,White,30,Trans*,3.39,FALSE,141,147,288,1.97
1910,White,20,Trans*,2.63,FALSE,160,148,308,3.05
0898,Black,29,Male,3.8,FALSE,157,153,310,2.81
1969,White,28,Trans*,1.56,FALSE,153,148,301,3.42
0691,Bi-Racial,21,Trans*,3.48,FALSE,153,161,314,2.81
551,White,24,Trans*,2.41,FALSE,136,140,276,1.97
158,Black,30,Female,2.78,FALSE,154,134,288,2.74
0368,Black,24,Female,3.36,FALSE,140,167,307,3.48
078,White,29,Trans*,2.74,TRUE,161,134,295,2.07
1985,White,23,Male,1.53,FALSE,155,159,314,3.39
198,Hispanic,21,Trans*,2.57,TRUE,165,141,306,3.93
1869,Black,21,Trans*,2.42,FALSE,147,148,295,2.64
1361,White,22,Trans*,1.23,FALSE,131,154,285,2.68
211,White,30,Male,2.56,FALSE,151,131,282,2.74
1115,White,24,Female,1.94,FALSE,130,164,294,1.8
0542,Black,21,Male,1.61,FALSE,153,162,315,1.07
647,White,20,Female,3.12,TRUE,135,132,267,3.06
1591,White,23,Trans*,1.4,FALSE,132,131,263,3
212,White,27,Female,2.78,TRUE,159,135,294,3.39
481,White,28,Female,2.1,TRUE,134,139,273,3.43
0105,White,30,Male,3.59,FALSE,143,169,312,3.49
1677,White,22,Male,1.26,FALSE,159,161,320,2.56
0684,Hispanic,27,Trans*,2.89,FALSE,134,134,268,2.92
0961,Hispanic,22,Trans*,2.5,FALSE,147,153,300,2.9
766,White,29,Male,2.55,TRUE,153,132,285,3.15
360,Hispanic,21,Male,2.28,TRUE,146,135,281,3.6
0013,Hispanic,29,Trans*,1.5,FALSE,138,141,279,3.5
188,White,22,Trans*,2.84,TRUE,146,144,290,2.98
394,Hispanic,30,Male,1.47,FALSE,137,134,271,2.76
112,White,20,Male,2.53,TRUE,143,130,273,3.78
1797,White,27,Male,3.12,FALSE,145,153,298,3.66
1088,White,24,Female,2.44,FALSE,160,136,296,2.9
1208,White,25,Male,1.62,FALSE,143,151,294,3.83
1848,Black,28,Trans*,3.71,FALSE,153,160,313,3.72
123,Native,21,Female,3.31,TRUE,131,133,264,3.05
138,Black,30,Trans*,2.01,FALSE,135,133,268,2.73
0279,White,21,Male,2.92,FALSE,137,169,306,2.73
0054,White,27,Male,2.26,FALSE,150,145,295,2.71
0470,Hispanic,23,Trans*,3.33,FALSE,141,163,304,2.74
176,Hispanic,21,Female,2.13,TRUE,136,138,274,3.61
1410,Asian,28,Trans*,1.16,FALSE,139,143,282,1.18
0505,White,27,Male,3.79,FALSE,133,150,283,3.08
1337,Native,27,Male,2.13,FALSE,140,156,296,3.59
154,Black,21,Male,2.95,TRUE,148,131,279,3.21
1401,Hispanic,28,Trans*,3.15,FALSE,156,147,303,2.39
749,Black,26,Trans*,2.14,FALSE,143,133,276,2.76
049,White,29,Trans*,2.96,TRUE,166,136,302,3.56
266,White,26,Male,3.07,TRUE,160,130,290,3.55
0079,White,23,Female,1.18,FALSE,155,161,316,3.56
344,Bi-Racial,27,Male,2.3,TRUE,148,146,294,3.81
155,White,30,Trans*,2.41,TRUE,134,130,264,3.99
522,White,20,Trans*,2.62,TRUE,149,130,279,3.66
233,White,28,Male,2.35,TRUE,141,140,281,3.79
0774,White,30,Trans*,2.84,FALSE,132,167,299,2.71
357,White,21,Male,3.03,TRUE,142,146,288,2.93
065,White,21,Trans*,2.66,FALSE,135,141,276,2.39
171,Hispanic,23,Female,1.67,TRUE,148,141,289,3.41
103,Black,26,Male,1.92,FALSE,142,134,276,2.4
1107,Asian,25,Male,1.82,FALSE,169,161,330,3.77
1036,White,26,Trans*,1.75,FALSE,137,160,297,2.55
1025,White,24,Male,1.4,FALSE,145,155,300,3.63
0590,White,21,Female,1.72,FALSE,133,168,301,2.55
0532,White,24,Male,2.59,FALSE,161,153,314,3.59
1894,Hispanic,20,Trans*,3.46,FALSE,166,141,307,2.99
217,Hispanic,21,Female,3.3,TRUE,142,132,274,2.54
377,Hispanic,21,Trans*,2.9,TRUE,153,132,285,2.2
389,Bi-Racial,27,Male,2.61,TRUE,130,131,261,2.59
1514,White,20,Trans*,1.04,FALSE,157,141,298,3.16
537,White,26,Trans*,2.94,FALSE,143,139,282,2.7
018,White,26,Female,1.91,FALSE,161,138,299,3.06
765,White,29,Female,2.28,TRUE,146,132,278,3.47
304,White,25,Male,2.32,TRUE,148,135,283,2.68
0460,White,22,Male,2.83,FALSE,168,141,309,3.78
0162,White,27,Female,3.31,FALSE,134,163,297,2.32
731,White,23,Trans*,2.91,FALSE,147,138,285,2.44
1367,White,26,Male,1.31,FALSE,162,153,315,2.63
556,Hispanic,20,Trans*,2.48,FALSE,161,137,298,3.04
0851,White,27,Trans*,2.98,FALSE,158,158,316,3.05
342,White,24,Female,2.14,FALSE,146,132,278,2.43
156,Bi-Racial,21,Female,2.44,TRUE,146,142,288,3.85
1538,White,23,Female,1.99,FALSE,131,160,291,3.63
0454,Black,23,Trans*,1.08,FALSE,161,167,328,2.86
0308,White,21,Trans*,2.72,FALSE,141,163,304,3.26
0571,White,22,Trans*,3.27,FALSE,155,165,320,2.86
1606,Black,30,Trans*,1.35,FALSE,162,149,311,3.51
1709,White,21,Female,1.65,FALSE,150,165,315,3.5
0740,White,28,Male,2.41,FALSE,149,162,311,3.4
308,White,26,Trans*,2.17,FALSE,165,137,302,3.77
540,Black,24,Trans*,2.69,FALSE,144,156,300,2.52
521,Black,27,Trans*,2.73,TRUE,151,134,285,3.44
326,White,23,Male,1.64,TRUE,145,142,287,3.38
0626,White,22,Trans*,3.34,FALSE,138,165,303,2.67
132,White,25,Female,2.91,FALSE,145,153,298,2.67
066,Hispanic,21,Male,2.58,TRUE,154,142,296,3.81
1950,White,20,Male,2.46,FALSE,158,143,301,2.31
1534,White,26,Female,2.62,FALSE,147,168,315,2.76
1203,Hispanic,30,Trans*,1.84,FALSE,135,142,277,3.71
0408,Black,21,Female,2.74,FALSE,147,141,288,1.95
0019,Native,20,Trans*,2.92,FALSE,131,130,261,2.67
472,White,21,Male,3.15,TRUE,164,152,316,3.92
682,White,27,Male,2.32,TRUE,160,130,290,3.44
629,White,20,Male,2.53,TRUE,142,141,283,2.65
1582,White,26,Trans*,1.5,FALSE,139,151,290,3.98
1790,Black,20,Trans*,1.89,FALSE,135,166,301,2.92
1302,White,22,Trans*,2.55,FALSE,137,142,279,3.21
1378,Hispanic,21,Male,3.92,FALSE,169,147,316,3.89
1148,White,27,Male,2.41,FALSE,139,162,301,3.37
456,Hispanic,27,Trans*,2.01,TRUE,169,136,305,3.32
593,White,23,Male,2.54,FALSE,165,134,299,2.8
0830,White,21,Male,2.93,FALSE,139,147,286,3.82
146,White,26,Male,2.35,FALSE,156,132,288,1.52
710,White,20,Male,1.39,TRUE,135,131,266,2.73
0407,White,25,Trans*,2.99,FALSE,151,164,315,3.87
114,White,22,Male,1.98,FALSE,156,134,290,3.05
177,White,20,Trans*,3.11,TRUE,144,137,281,3.93
1670,White,25,Male,1.98,FALSE,148,131,279,2.59
0067,White,30,Male,3.29,FALSE,133,140,273,3.74
478,White,20,Male,2.28,FALSE,166,132,298,3.02
1210,Hispanic,22,Female,2.72,FALSE,148,159,307,1.62
390,Asian,21,Female,2.4,TRUE,142,136,278,3.41
209,White,30,Male,1.99,TRUE,144,136,280,2.58
1854,Native,26,Trans*,3.48,FALSE,134,131,265,3.99
0442,Hispanic,27,Trans*,2.49,FALSE,161,149,310,3.64
0812,White,25,Male,2.57,FALSE,143,136,279,3.35
1253,White,23,Trans*,2.9,FALSE,154,162,316,3.26
1755,White,25,Male,2.52,FALSE,137,170,307,3.16
487,Black,25,Male,2.22,FALSE,164,132,296,2.12
1540,White,27,Female,2.73,FALSE,156,141,297,3.92
347,White,28,Female,1.82,TRUE,164,140,304,3.91
0478,White,21,Female,2.08,FALSE,155,164,319,2.81
1924,White,20,Trans*,1.51,FALSE,135,141,276,1.55
335,White,21,Male,2.76,TRUE,152,137,289,3.59
1470,Hispanic,24,Trans*,2.09,FALSE,164,162,326,3.06
1434,White,21,Trans*,2.3,FALSE,148,156,304,3.94
151,Hispanic,28,Male,2.92,FALSE,138,133,271,2.66
346,White,21,Female,2.22,TRUE,134,136,270,3.67
515,White,30,Male,2.09,TRUE,150,131,281,3.62
384,White,30,Trans*,3,TRUE,133,146,279,3.16
1490,Hispanic,30,Trans*,1.47,FALSE,134,130,264,1.92
1729,Black,23,Female,2.55,FALSE,141,147,288,3.06
620,Black,27,Trans*,2.34,FALSE,134,132,266,2.34
1347,White,22,Trans*,2.5,FALSE,155,143,298,1.72
0892,Black,24,Male,2.47,FALSE,141,156,297,3.59
1151,Black,30,Male,2.95,FALSE,159,147,306,3.36
0339,Hispanic,22,Female,3.11,FALSE,144,161,305,3.49
689,White,23,Female,2.39,TRUE,154,133,287,3.79
0525,Hispanic,27,Female,2.96,FALSE,148,141,289,3.36
0983,White,30,Male,2.16,FALSE,145,155,300,3.34
131,White,20,Trans*,3.33,FALSE,163,135,298,3.18
577,White,21,Male,2.87,TRUE,164,135,299,3.94
0634,White,27,Male,3.26,FALSE,161,132,293,3.43
1316,Black,28,Trans*,1.77,FALSE,142,144,286,2.4
0558,White,25,Male,3.85,FALSE,142,168,310,2.32
0078,White,29,Trans*,2.45,FALSE,165,148,313,2.53
503,White,20,Trans*,2.6,FALSE,151,134,285,2.6
021,Black,22,Trans*,3.22,FALSE,140,143,283,2.76
685,Asian,26,Trans*,2.74,FALSE,163,145,308,2.8
687,Black,20,Male,2.79,TRUE,151,130,281,3.56
719,White,24,Female,1.98,FALSE,145,135,280,2.83
1526,White,23,Male,2.87,FALSE,148,164,312,3.42
1215,White,23,Trans*,2.21,FALSE,147,132,279,3.97
0907,White,28,Trans*,2.62,FALSE,152,163,315,3.12
094,White,24,Trans*,3.23,FALSE,146,138,284,2.65
0995,White,25,Trans*,2.36,FALSE,141,167,308,2.62
1527,White,26,Female,1.93,FALSE,159,158,317,3.53
050,Hispanic,30,Male,3.06,TRUE,140,134,274,3.61
549,White,28,Male,2.53,FALSE,146,135,281,3.02
474,Asian,21,Male,3.21,TRUE,139,140,279,3.05
1565,Bi-Racial,25,Female,2.47,FALSE,134,149,283,2.06
379,White,24,Male,2.33,TRUE,145,138,283,3.87
0827,White,23,Male,1.88,FALSE,151,155,306,3.58
0227,Black,23,Trans*,1.91,FALSE,166,135,301,3.59
247,White,21,Female,2.25,FALSE,137,141,278,3.24
427,White,20,Female,2.24,FALSE,154,134,288,3.44
306,White,23,Female,2.23,TRUE,132,134,266,3.77
079,White,22,Male,2.03,TRUE,146,130,276,3.18
417,Hispanic,24,Male,1.69,FALSE,136,144,280,3.48
294,White,27,Female,2.63,TRUE,154,132,286,3.75
703,Hispanic,25,Male,3.04,FALSE,140,131,271,2.92
1421,White,23,Female,1.91,FALSE,144,158,302,3.39
1697,White,29,Male,1.42,FALSE,149,146,295,2.95
1872,White,21,Male,1.66,FALSE,143,164,307,3.76
606,White,24,Female,2.56,TRUE,159,146,305,3.67
611,White,28,Female,2.1,TRUE,161,131,292,3.43
1441,White,27,Male,3.29,FALSE,152,165,317,3.62
464,White,20,Male,2.66,TRUE,148,152,300,3.65
1064,Black,23,Trans*,1.87,FALSE,168,161,329,3.42
0161,White,20,Trans*,2.11,FALSE,153,149,302,3.53
046,White,30,Trans*,2.24,TRUE,147,131,278,2.77
0621,Bi-Racial,30,Male,3.8,FALSE,142,132,274,3.52
458,White,22,Male,2.83,TRUE,134,140,274,2.47
0451,White,26,Male,3.64,FALSE,158,139,297,3.31
0954,White,22,Male,1.9,FALSE,142,131,273,3.22
0369,Asian,25,Trans*,1.06,FALSE,160,155,315,2.17
0473,Hispanic,29,Male,1.47,FALSE,146,130,276,3.93
648,White,27,Trans*,2.12,FALSE,151,130,281,3.39
1173,White,23,Trans*,2.04,FALSE,157,146,303,3.41
0356,White,26,Trans*,1.69,FALSE,148,149,297,1.44
0808,White,23,Male,2.66,FALSE,150,149,299,2.59
0491,Black,27,Female,2.27,FALSE,150,131,281,3.77
372,White,27,Trans*,2.44,TRUE,163,132,295,3.27
0319,White,22,Female,1.73,FALSE,138,145,283,3.54
602,White,30,Male,2.97,TRUE,131,132,263,3.41
119,White,28,Trans*,3.12,TRUE,155,137,292,3.53
062,White,29,Trans*,3.41,TRUE,157,137,294,2.7
184,Bi-Racial,23,Female,2.62,FALSE,154,130,284,3.11
0236,Hispanic,22,Female,1.64,FALSE,149,141,290,1.96
0906,Hispanic,26,Female,2.53,FALSE,147,163,310,2.89
0825,White,23,Trans*,1.84,FALSE,136,170,306,3.63
672,Asian,25,Male,1.85,TRUE,150,139,289,3.04
286,White,27,Female,2.82,FALSE,153,138,291,2.91
548,Black,27,Male,2.81,TRUE,133,142,275,3.78
1245,Bi-Racial,23,Trans*,2.37,FALSE,161,133,294,2.41
1788,Hispanic,22,Trans*,1.58,FALSE,146,138,284,3.77
0002,Black,23,Trans*,2.52,FALSE,153,131,284,2.62
0467,White,24,Female,2.28,FALSE,137,143,280,2.34
183,White,24,Male,2.59,TRUE,132,137,269,3.23
0420,Hispanic,23,Female,1.14,FALSE,163,158,321,2.83
0782,White,21,Female,2.54,FALSE,135,150,285,3.53
1196,White,21,Male,1.07,FALSE,133,131,264,2.09
197,Black,20,Trans*,2.63,TRUE,146,142,288,2.79
0344,White,21,Trans*,1.47,FALSE,147,151,298,2.89
1933,White,25,Trans*,2.46,FALSE,148,150,298,3.48
433,Hispanic,28,Female,3.11,FALSE,148,132,280,2.85
0057,Hispanic,20,Male,2.89,FALSE,134,158,292,3.4
367,Hispanic,27,Female,2.38,TRUE,148,144,292,3.69
1871,Asian,28,Trans*,3.51,FALSE,135,166,301,3.88
351,Hispanic,24,Female,3.43,FALSE,152,147,299,3.44
0555,White,20,Female,3.4,FALSE,141,155,296,3.1
712,White,24,Trans*,2.41,FALSE,149,132,281,3.29
246,Hispanic,20,Female,2.92,FALSE,144,134,278,2.74
099,Black,23,Female,1.66,FALSE,140,137,277,3.21
010,White,29,Male,2.9,FALSE,149,131,280,3.72
1311,Hispanic,22,Trans*,2.11,FALSE,148,138,286,3.25
0619,White,21,Female,3.02,FALSE,141,133,274,2.92
0423,White,26,Male,1.37,FALSE,138,148,286,2.77
470,White,25,Female,2.29,TRUE,138,133,271,3.72
0712,Hawaiian,28,Female,3.18,FALSE,144,139,283,3.94
276,White,27,Trans*,3.1,TRUE,161,137,298,3.45
571,Hispanic,24,Trans*,2.99,FALSE,134,131,265,3.91
0414,Native,20,Female,2.13,FALSE,149,145,294,2.88
707,Hispanic,21,Female,2.64,FALSE,168,136,304,2.63
0231,White,25,Male,1.99,FALSE,157,148,305,2.71
0185,White,25,Trans*,2.42,FALSE,140,164,304,2.39
643,White,30,Female,2.85,TRUE,156,134,290,3.29
0652,White,25,Female,1.85,FALSE,148,166,314,1.6
1847,White,29,Female,3.29,FALSE,138,142,280,1.16
224,White,30,Trans*,2.71,TRUE,166,134,300,3.19
231,White,28,Trans*,2.68,FALSE,157,161,318,3.34
530,White,27,Male,2.65,TRUE,146,132,278,2.84
1222,White,27,Male,2.64,FALSE,147,159,306,3.4
523,White,28,Male,2.63,TRUE,151,130,281,2.85
1930,Black,23,Male,2.44,FALSE,156,162,318,2.67
0127,White,29,Trans*,1.37,FALSE,146,133,279,2.86
475,White,24,Trans*,2.87,FALSE,154,134,288,3.05
557,White,25,Female,2.52,TRUE,130,131,261,3.47
1504,White,28,Male,3.02,FALSE,158,166,324,2.28
628,White,25,Female,2.8,FALSE,144,134,278,2.32
0637,White,24,Female,2.7,FALSE,150,143,293,1.31
0036,Hispanic,25,Male,2.86,FALSE,156,162,318,3.38
649,White,22,Female,1.73,TRUE,166,144,310,3.29
0715,White,22,Female,1.26,FALSE,151,130,281,3.76
1226,White,28,Male,1.67,FALSE,141,147,288,2.28
746,Black,20,Male,2.69,FALSE,155,147,302,1.96
1771,White,20,Trans*,2.9,FALSE,131,138,269,3.07
1617,White,24,Female,1.54,FALSE,141,164,305,3.32
0048,White,21,Trans*,3.46,FALSE,148,159,307,2.84
009,Hispanic,23,Trans*,2.15,TRUE,143,135,278,3.82
386,White,26,Male,2.71,TRUE,158,142,300,3.02
593,White,26,Trans*,2.73,TRUE,154,131,285,3.61
741,White,22,Female,2.71,FALSE,144,136,280,2.92
0276,Asian,27,Trans*,2.58,FALSE,134,156,290,1.78
1846,White,27,Male,3.05,FALSE,158,150,308,3.61
0646,White,20,Male,2.9,FALSE,144,136,280,3.18
1826,Black,24,Trans*,2.58,FALSE,131,158,289,3.42
0888,White,24,Trans*,2.41,FALSE,146,157,303,2.78
407,Hispanic,30,Trans*,2.59,TRUE,143,135,278,2.85
086,Black,20,Male,2.46,TRUE,135,143,278,2.75
0418,Black,28,Male,2.75,FALSE,148,162,310,2.52
0627,White,29,Trans*,1.25,FALSE,155,166,321,3.2
203,White,22,Trans*,2.78,TRUE,146,153,299,3.93
729,White,27,Trans*,2.74,FALSE,141,136,277,3.37
375,White,27,Female,1.71,TRUE,138,134,272,3.22
595,White,23,Male,1.53,TRUE,134,130,264,3.53
534,Asian,25,Male,2.96,FALSE,145,134,279,3.49
489,White,20,Female,3.15,FALSE,144,134,278,3.13
420,White,27,Female,2.69,TRUE,151,138,289,3.11
041,White,27,Male,2.92,TRUE,148,135,283,2.89
473,White,30,Trans*,1.83,TRUE,149,132,281,2.82
689,White,22,Male,2.52,FALSE,151,131,282,2.35
036,White,24,Male,3.13,FALSE,149,143,292,2.28
0908,White,21,Male,3.44,FALSE,155,164,319,3.17
1552,Asian,26,Female,2.97,FALSE,132,169,301,3.85
619,Hispanic,25,Female,2.39,FALSE,131,133,264,3.1
1079,White,20,Male,3.68,FALSE,132,167,299,3.33
723,White,21,Male,2.16,FALSE,138,146,284,3.47
0151,White,27,Male,2.15,FALSE,137,152,289,3.08
0492,White,25,Trans*,1.49,FALSE,146,133,279,3.21
0249,Hispanic,29,Female,1.35,FALSE,151,144,295,1.3
248,Black,26,Trans*,2.92,FALSE,147,144,291,2.84
1665,Hispanic,22,Female,3.51,FALSE,150,143,293,3.95
349,Hispanic,25,Female,2.15,FALSE,163,147,310,3.86
1774,White,24,Male,1.71,FALSE,145,163,308,3.26
101,White,25,Male,2.79,TRUE,144,130,274,3.73
783,Black,28,Male,1.95,FALSE,164,137,301,2.79
0118,Black,24,Trans*,2.51,FALSE,141,131,272,3.09
1415,White,22,Male,1.6,FALSE,163,148,311,2.19
0527,Hispanic,28,Female,1.59,FALSE,134,152,286,3.2
524,Asian,23,Female,2.72,TRUE,130,131,261,3.58
752,Hispanic,21,Trans*,3.14,TRUE,152,157,309,3.7
525,White,23,Male,2.99,TRUE,135,134,269,3.04
780,White,25,Female,2.66,FALSE,156,132,288,2.86
774,Hispanic,30,Male,3.04,FALSE,148,133,281,2.73
0561,Hispanic,26,Trans*,1.9,FALSE,154,159,313,1.72
740,Black,22,Trans*,2.75,FALSE,155,136,291,2.43
392,Hispanic,27,Female,2.67,TRUE,154,134,288,3.39
0331,White,24,Female,1.38,FALSE,143,165,308,3.77
162,White,28,Trans*,1.75,FALSE,134,135,269,3.23
1349,White,23,Male,2.1,FALSE,137,143,280,2.65
1948,White,27,Trans*,2.29,FALSE,134,164,298,3.55
1796,White,25,Female,1.53,FALSE,148,155,303,3.37
0175,White,23,Female,3.1,FALSE,137,161,298,2.53
1831,White,25,Female,3.35,FALSE,168,144,312,3.27
1108,White,29,Trans*,1.08,FALSE,165,133,298,3.75
091,Black,21,Male,2.57,FALSE,145,134,279,2.83
1976,White,27,Male,3.02,FALSE,133,139,272,2.49
668,White,22,Trans*,3.14,TRUE,135,135,270,3.24
1201,White,27,Female,1.48,FALSE,146,165,311,3.68
119,White,26,Male,1.8,FALSE,157,132,289,1.52
274,Hispanic,30,Female,2.92,FALSE,131,134,265,2.66
031,White,23,Female,2.8,TRUE,159,130,289,2.91
466,White,28,Trans*,2.26,FALSE,149,133,282,3.62
0374,White,21,Trans*,1.13,FALSE,136,141,277,2.97
1385,White,23,Female,3.76,FALSE,166,158,324,3.93
1857,Black,29,Female,3.01,FALSE,156,154,310,3.35
0444,White,30,Male,3.18,FALSE,155,145,300,1.67
0156,Bi-Racial,26,Trans*,1.55,FALSE,154,163,317,2.8
0955,White,22,Trans*,1.51,FALSE,141,147,288,3.7
0706,White,22,Male,2.11,FALSE,149,139,288,2.54
1119,White,29,Female,3.68,FALSE,161,147,308,1.73
113,Asian,24,Male,2.89,TRUE,130,144,274,3.59
042,White,28,Male,1.77,FALSE,130,132,262,3.56
1558,Hispanic,20,Trans*,1.67,FALSE,145,148,293,2.01
1103,White,30,Trans*,3.01,FALSE,133,167,300,3.63
0062,Hispanic,20,Trans*,2.9,FALSE,131,165,296,3.46
0480,Hispanic,26,Male,2.98,FALSE,159,160,319,3.2
0430,White,30,Female,2.31,FALSE,134,170,304,3.82
0299,White,28,Female,3.72,FALSE,149,170,319,2.64
186,White,28,Female,2.24,TRUE,163,135,298,2.61
379,White,29,Trans*,2.72,FALSE,143,140,283,2.93
600,Black,29,Trans*,2.44,FALSE,147,143,290,3.35
0502,White,26,Male,3.73,FALSE,152,142,294,2.84
1167,White,24,Trans*,2.04,FALSE,138,160,298,3.88
0094,White,24,Female,2.28,FALSE,156,164,320,2.79
1209,Hispanic,20,Trans*,2.38,FALSE,154,162,316,2.93
1052,Hispanic,25,Female,1.07,FALSE,148,162,310,3.46
0243,White,30,Trans*,1.23,FALSE,133,169,302,2.69
775,Hispanic,23,Female,3.42,FALSE,134,133,267,3.15
0419,White,29,Female,3.25,FALSE,132,146,278,3.24
449,White,23,Male,2.73,TRUE,143,149,292,3.53
265,Black,20,Trans*,2.84,FALSE,130,135,265,2.06
617,Hispanic,24,Male,2.42,FALSE,151,138,289,2.54
1013,Hispanic,22,Male,1.94,FALSE,152,133,285,3.69
337,White,20,Female,2.88,FALSE,152,134,286,2.82
750,White,28,Male,2.11,FALSE,137,136,273,3.46
506,White,21,Trans*,2.81,FALSE,154,135,289,3.23
258,White,29,Male,3.2,FALSE,154,131,285,2.41
1507,Black,22,Male,2.71,FALSE,155,153,308,3.48
287,White,25,Trans*,2.74,TRUE,162,131,293,3.69
0381,Hispanic,30,Male,1.14,FALSE,134,133,267,3.85
497,White,22,Female,2.83,FALSE,135,137,272,3.57
310,Hispanic,23,Female,2.74,TRUE,166,138,304,3.3
1878,White,28,Male,1.93,FALSE,133,138,271,3.5
311,Hispanic,22,Trans*,2.86,FALSE,134,142,276,2.33
1700,Native,23,Trans*,2.72,FALSE,151,164,315,1.84
1607,White,23,Female,1.21,FALSE,146,159,305,3.95
1045,White,20,Female,3.18,FALSE,149,163,312,3.41
488,Hispanic,24,Female,2.8,TRUE,139,134,273,3.61
1070,Black,28,Trans*,2.08,FALSE,140,140,280,1.92
494,White,30,Trans*,2.84,FALSE,143,137,280,2.54
777,White,24,Trans*,2.84,TRUE,136,134,270,3.51
0912,White,20,Trans*,3.38,FALSE,136,159,295,2.15
079,White,29,Male,2.82,FALSE,144,133,277,3.01
166,Hispanic,22,Male,2.76,FALSE,135,152,287,2.37
0576,White,29,Trans*,1.86,FALSE,159,140,299,3.07
1059,White,29,Female,2.8,FALSE,142,142,284,2.36
0141,White,22,Male,1.37,FALSE,134,156,290,3.74
1240,White,29,Female,1.03,FALSE,152,145,297,2.34
0953,White,30,Trans*,1.47,FALSE,154,164,318,3.95
290,Black,24,Trans*,2.51,TRUE,156,143,299,2.93
1097,Hispanic,30,Female,2.04,FALSE,155,160,315,2.86
1904,Hispanic,29,Trans*,3.62,FALSE,134,148,282,2.85
039,Native,21,Male,2.4,TRUE,144,140,284,3.72
575,White,25,Female,2.61,FALSE,136,142,278,2.6
264,White,25,Trans*,2.65,FALSE,161,137,298,3.81
234,White,20,Trans*,2.36,FALSE,152,131,283,3.2
572,Black,27,Trans*,2.06,TRUE,169,132,301,3.32
005,White,22,Trans*,2.25,FALSE,148,144,292,3.1
0393,Asian,21,Female,1.35,FALSE,147,145,292,3.7
0843,Hawaiian,21,Female,1.11,FALSE,132,136,268,3.56
1056,White,24,Trans*,3.89,FALSE,142,143,285,3.99
567,White,29,Female,3.07,FALSE,138,142,280,2.91
061,Hispanic,29,Female,2,FALSE,159,131,290,1.75
1689,Black,24,Male,1.24,FALSE,132,160,292,3.29
0860,White,22,Male,1.98,FALSE,151,133,284,3.54
1184,White,23,Trans*,3.56,FALSE,147,156,303,2.66
0624,White,27,Female,1.05,FALSE,144,130,274,3.17
499,White,27,Male,1.86,FALSE,164,131,295,3.04
699,White,30,Male,2.64,TRUE,142,144,286,3.62
0512,White,20,Female,3.99,FALSE,150,132,282,3.85
1899,White,26,Trans*,1.11,FALSE,160,155,315,2.85
1979,Black,29,Trans*,1.57,FALSE,135,150,285,3.77
454,Hispanic,24,Trans*,1.93,FALSE,155,135,290,2.6
709,White,25,Male,2.26,FALSE,134,132,266,3.42
1020,White,29,Male,2.66,FALSE,156,141,297,3.2
669,Asian,20,Trans*,1.95,FALSE,156,139,295,3.69
176,Black,26,Female,2.45,FALSE,162,139,301,2.53
1272,White,30,Trans*,2.27,FALSE,164,135,299,3.55
1497,White,26,Trans*,1.45,FALSE,131,158,289,2.17
1757,White,26,Trans*,3.27,FALSE,151,150,301,3.58
642,White,25,Female,2.6,TRUE,151,134,285,3.43
0461,White,28,Male,3.16,FALSE,141,169,310,3.6
060,Black,23,Trans*,2.08,TRUE,149,132,281,3.93
1246,White,27,Female,1.76,FALSE,149,162,311,3.58
0975,White,25,Female,2.12,FALSE,152,155,307,3.38
0421,Black,23,Female,2.8,FALSE,156,158,314,2.71
0879,White,24,Female,3.67,FALSE,144,164,308,2.19
1235,Hispanic,21,Female,2.27,FALSE,139,154,293,2.86
1887,White,23,Male,2.2,FALSE,162,154,316,2.41
768,White,24,Male,1.96,TRUE,155,142,297,3.63
0930,White,30,Male,1.58,FALSE,160,154,314,3.52
020,Hispanic,29,Male,3.19,FALSE,155,132,287,3.54
0636,White,25,Male,3.78,FALSE,144,138,282,3.97
787,Black,24,Trans*,2.02,TRUE,163,132,295,2.58
443,White,21,Male,2.04,FALSE,168,151,319,3.05
733,White,28,Male,2.05,TRUE,132,142,274,3.49
338,White,25,Trans*,2.36,FALSE,161,137,298,2.9
1961,White,27,Female,2.16,FALSE,150,170,320,3.56
423,White,28,Female,1.47,TRUE,142,137,279,3.12
247,Hispanic,25,Male,2.03,TRUE,138,132,270,3.28
1075,Asian,28,Trans*,2.76,FALSE,134,158,292,3.08
1143,Hispanic,22,Male,2.69,FALSE,168,164,332,2.69
084,White,20,Male,2.45,TRUE,152,132,284,3.4
1011,White,24,Trans*,2.34,FALSE,159,154,313,3.93
421,White,28,Female,1.65,FALSE,145,141,286,2.05
0384,Black,27,Male,3.62,FALSE,153,162,315,2.93
0939,Black,27,Male,3.21,FALSE,143,164,307,1.77
023,White,25,Trans*,2.75,FALSE,131,136,267,3.01
1839,Hispanic,25,Female,1.99,FALSE,157,153,310,3.39
1356,White,20,Male,1.54,FALSE,158,161,319,3.89
0946,Black,25,Trans*,3.87,FALSE,147,166,313,1.72
645,White,28,Trans*,1.98,FALSE,158,163,321,2.92
1014,White,30,Trans*,1.2,FALSE,137,164,301,2.09
441,White,27,Male,2.47,FALSE,158,137,295,2.83
140,Black,22,Male,1.41,TRUE,166,137,303,3.06
0747,Black,26,Male,2.09,FALSE,159,157,316,3.34
196,Black,20,Trans*,1.49,TRUE,150,138,288,3.6
1325,White,25,Trans*,3.16,FALSE,146,166,312,3
720,White,26,Trans*,2.56,TRUE,132,131,263,3.22
773,Black,25,Female,1.87,TRUE,141,133,274,3.77
0833,Black,27,Male,2.36,FALSE,168,162,330,2.42
121,White,27,Trans*,2.7,FALSE,154,151,305,2.88
144,White,30,Female,2.66,TRUE,147,149,296,3.54
152,White,22,Trans*,3.33,TRUE,134,133,267,3.38
138,White,28,Male,2.61,TRUE,132,138,270,2.94
1484,White,22,Trans*,1.56,FALSE,155,163,318,2.31
1327,White,29,Trans*,3.1,FALSE,138,164,302,3.75
1458,White,20,Male,2.8,FALSE,149,169,318,2.7
1898,Hispanic,28,Male,2.82,FALSE,139,135,274,3.94
709,White,21,Male,2.13,TRUE,145,136,281,3.84
0748,White,24,Trans*,2.27,FALSE,147,159,306,3.27
1840,White,20,Female,2.93,FALSE,150,152,302,3.81
1174,White,29,Trans*,3.92,FALSE,134,159,293,3.72
0160,White,28,Trans*,3.48,FALSE,146,148,294,2.87
0711,White,24,Female,1.95,FALSE,148,134,282,3.33
397,Hispanic,26,Female,3.01,FALSE,144,131,275,2.6
182,White,25,Male,1.94,TRUE,130,143,273,3.11
501,White,24,Female,2.97,FALSE,133,143,276,3.23
021,White,20,Female,2.62,TRUE,149,138,287,3.77
362,White,25,Trans*,2.32,TRUE,155,133,288,2
0839,White,28,Trans*,2.21,FALSE,139,136,275,3.39
0198,White,28,Trans*,1.38,FALSE,167,137,304,2.94
694,Native,25,Trans*,2.6,FALSE,137,137,274,2.92
658,White,24,Male,2.63,FALSE,132,138,270,1.99
0974,White,23,Trans*,3.86,FALSE,164,155,319,3.26
0237,White,26,Trans*,1.01,FALSE,131,153,284,3.74
125,White,22,Male,2.18,TRUE,137,136,273,3.49
789,Hispanic,29,Female,3.16,TRUE,162,133,295,3.05
1386,White,29,Male,3.5,FALSE,166,150,316,2.64
1549,White,29,Male,2.55,FALSE,134,166,300,3.75
1708,Hispanic,30,Male,2.21,FALSE,163,156,319,2.4
208,White,30,Male,2.42,TRUE,164,131,295,3.12
1185,White,26,Male,2.85,FALSE,142,131,273,3.3
026,Black,25,Male,1.55,TRUE,156,135,291,2.96
0865,Asian,29,Male,1.23,FALSE,143,138,281,1.9
1092,White,22,Female,2.5,FALSE,141,142,283,1.86
666,White,23,Male,2.01,TRUE,158,145,303,2.95
0357,Black,28,Female,1.76,FALSE,151,153,304,2.33
003,White,24,Female,3.24,TRUE,136,138,274,3.4
0567,Hispanic,21,Trans*,1.04,FALSE,163,161,324,2.75
1740,White,28,Male,1.09,FALSE,150,153,303,2.37
1974,White,23,Trans*,2.09,FALSE,163,135,298,3.51
0109,Black,21,Female,3.16,FALSE,136,136,272,2.78
1069,White,23,Male,3.22,FALSE,151,143,294,2.75
565,Black,29,Trans*,2.11,FALSE,140,137,277,1.38
652,White,23,Male,2.42,FALSE,155,132,287,2.86
442,Black,24,Female,2.86,TRUE,152,133,285,3.78
1629,White,24,Trans*,2.43,FALSE,147,160,307,2.68
0071,Hispanic,22,Female,2.27,FALSE,158,151,309,3.11
0623,Asian,24,Trans*,3.73,FALSE,142,147,289,3.32
1977,Hispanic,20,Female,2.19,FALSE,149,168,317,3.68
099,White,30,Male,2.63,TRUE,144,144,288,3.19
1621,White,23,Female,2.08,FALSE,149,139,288,2.93
667,Hispanic,23,Female,2.76,TRUE,146,136,282,3.44
228,White,20,Female,2.98,TRUE,149,139,288,3.51
120,Hispanic,30,Trans*,1.88,TRUE,160,134,294,3.16
234,Black,25,Female,1.53,TRUE,152,130,282,3.26
762,Hispanic,23,Female,2.69,TRUE,141,136,277,3.15
763,White,23,Female,2.28,FALSE,158,130,288,3.35
1063,White,25,Female,2.55,FALSE,150,164,314,2.6
1666,Black,30,Male,3.21,FALSE,145,169,314,1.73
660,Asian,21,Male,3.17,TRUE,140,143,283,2.59
367,Hispanic,29,Female,1.71,FALSE,147,139,286,2.27
210,Hispanic,25,Male,3.12,FALSE,143,132,275,3.51
0792,White,20,Trans*,2.75,FALSE,154,134,288,3.8
1838,Hispanic,27,Female,3.31,FALSE,142,147,289,2.97
0593,White,27,Trans*,3.24,FALSE,157,130,287,3.45
096,White,29,Trans*,1.48,TRUE,159,135,294,2.68
388,Black,27,Female,1.78,FALSE,157,135,292,2.46
0613,White,23,Trans*,1.75,FALSE,135,145,280,3.08
1273,Black,27,Female,2.01,FALSE,140,136,276,3.69
629,White,30,Trans*,2.62,FALSE,146,141,287,2.35
533,Black,29,Male,3.18,FALSE,168,146,314,3.77
0282,White,23,Male,2.18,FALSE,143,160,303,2.39
004,White,21,Trans*,2.78,TRUE,137,134,271,2.56
508,Hispanic,22,Female,2.12,FALSE,164,153,317,3.14
0916,Black,21,Female,3.46,FALSE,152,133,285,3.1
1650,White,24,Male,3.32,FALSE,159,159,318,3.89
0296,White,23,Male,2.72,FALSE,138,150,288,2.63
0805,Hispanic,29,Female,2.36,FALSE,164,154,318,3.99
453,Other,22,Trans*,2.4,TRUE,147,133,280,3
303,White,27,Female,3.18,TRUE,144,131,275,2.77
0004,White,21,Male,3.87,FALSE,152,154,306,3.57
1579,White,21,Female,2.05,FALSE,137,159,296,3.65
667,Hispanic,25,Trans*,2.29,FALSE,142,135,277,2.14
157,White,23,Male,2.35,TRUE,134,131,265,2.88
1635,White,26,Male,3.07,FALSE,137,159,296,3.31
1138,White,21,Female,2.13,FALSE,158,166,324,2.84
0178,Black,27,Female,2.15,FALSE,139,137,276,3.67
0045,White,26,Male,3.32,FALSE,143,147,290,2.68
0653,White,22,Trans*,2.42,FALSE,164,136,300,2.03
207,White,26,Female,3.22,TRUE,135,135,270,2.52
446,White,22,Trans*,2.02,FALSE,168,132,300,3.77
117,Asian,27,Trans*,2.33,FALSE,141,132,273,2.72
207,White,28,Female,2.17,FALSE,167,132,299,3.66
0441,White,28,Male,3.81,FALSE,140,162,302,3.59
0355,Hispanic,27,Trans*,2.41,FALSE,138,154,292,3.57
0173,White,29,Male,1.73,FALSE,140,169,309,3.54
445,Bi-Racial,24,Trans*,2.33,TRUE,170,144,314,3.31
1651,White,21,Trans*,1.83,FALSE,151,162,313,2.16
0579,White,25,Female,2.75,FALSE,161,152,313,2.64
0596,White,28,Male,1.12,FALSE,147,151,298,2.23
1425,White,29,Female,2.4,FALSE,132,145,277,4
0736,White,30,Male,3.9,FALSE,170,141,311,3.82
1554,White,20,Trans*,1.72,FALSE,137,159,296,2.74
425,Asian,26,Female,2.35,TRUE,163,143,306,3.91
127,White,22,Female,2.43,TRUE,169,155,324,3.53
612,Hispanic,23,Female,2.39,FALSE,142,133,275,3.03
215,White,26,Female,3.15,TRUE,151,136,287,2.94
1543,White,25,Trans*,2.27,FALSE,146,161,307,2.8
603,Black,27,Female,2.38,FALSE,169,153,322,3.34
0632,White,26,Male,1.81,FALSE,131,154,285,3.69
627,Black,26,Female,2.26,FALSE,141,133,274,2.62
747,White,23,Female,2.57,FALSE,140,137,277,2.2
0135,White,28,Male,1.89,FALSE,139,142,281,3.1
052,White,20,Male,2.53,TRUE,152,135,287,3.67
1819,Black,26,Trans*,2.73,FALSE,144,141,285,3.25
240,White,24,Male,2.39,FALSE,143,137,280,3.03
0464,White,27,Female,2.05,FALSE,139,169,308,2.64
1895,White,30,Female,1.98,FALSE,137,143,280,1.77
0133,White,24,Male,2.83,FALSE,146,143,289,3.95
1117,White,26,Male,1.98,FALSE,152,170,322,3.65
1371,White,25,Female,3.01,FALSE,139,147,286,1.03
0170,White,26,Trans*,1.45,FALSE,133,146,279,2.99
0809,Hispanic,27,Female,2.81,FALSE,166,135,301,3.26
0780,Hispanic,21,Trans*,1.74,FALSE,168,169,337,3.67
699,White,30,Male,2.31,FALSE,144,141,285,2.37
1023,White,23,Trans*,3.23,FALSE,135,130,265,3.52
0281,White,26,Male,3.82,FALSE,134,158,292,3.04
365,Black,27,Trans*,2.26,TRUE,146,146,292,3.51
0195,White,22,Trans*,2.52,FALSE,155,164,319,3.12
377,White,22,Male,2.68,FALSE,163,141,304,2.86
0028,Asian,21,Male,2.72,FALSE,137,166,303,1.5
0845,Hispanic,26,Trans*,2.03,FALSE,132,165,297,2.38
634,Hispanic,24,Female,2.12,FALSE,164,135,299,2.46
059,White,22,Male,2.7,TRUE,149,143,292,3.67
0126,White,23,Female,2.31,FALSE,144,168,312,3.23
1095,White,22,Female,2.77,FALSE,156,143,299,3.55
051,Hispanic,26,Trans*,1.75,FALSE,146,135,281,2.07
589,Asian,24,Male,2.27,FALSE,154,133,287,2.63
136,White,28,Trans*,2.48,TRUE,147,130,277,3.02
0307,Hispanic,21,Female,1.67,FALSE,148,159,307,2.6
592,Black,22,Trans*,3.64,TRUE,139,139,278,3.14
0104,Hispanic,20,Female,1.93,FALSE,144,162,306,2.11
0455,White,28,Trans*,3.47,FALSE,143,165,308,3.39
252,White,25,Female,2.05,FALSE,133,138,271,2.96
0820,Black,30,Female,1.65,FALSE,152,158,310,1.93
1814,White,29,Trans*,2.92,FALSE,162,152,314,3.87
0096,Asian,23,Male,2.72,FALSE,158,144,302,3.45
256,White,26,Female,2.53,FALSE,149,143,292,2.95
0548,White,30,Male,2.15,FALSE,152,154,306,3.21
1982,Black,22,Trans*,1.51,FALSE,155,157,312,3.89
1517,Hispanic,26,Female,3.53,FALSE,136,151,287,2.33
1288,White,28,Trans*,3.2,FALSE,139,166,305,3.02
736,Hispanic,29,Male,2.87,FALSE,157,131,288,2.18
256,White,22,Female,3.45,TRUE,149,146,295,3.02
0801,White,29,Male,3.03,FALSE,145,159,304,2.03
1934,Asian,30,Male,1.28,FALSE,154,132,286,3.43
0085,White,23,Female,2.61,FALSE,141,149,290,3.7
065,White,20,Male,3.11,TRUE,147,138,285,3.85
277,White,20,Trans*,2.13,FALSE,144,131,275,2.82
650,White,22,Male,3.25,FALSE,147,139,286,3.42
107,White,30,Male,2.38,TRUE,136,133,269,3
124,Asian,26,Female,3.04,TRUE,165,130,295,3.1
0483,White,23,Male,2.44,FALSE,159,166,325,3.93
1318,Bi-Racial,30,Trans*,1.48,FALSE,155,166,321,2.72
1852,Black,25,Female,3.95,FALSE,150,142,292,1.29
462,Hispanic,21,Female,2.31,FALSE,158,132,290,3.13
0574,White,22,Male,2.89,FALSE,143,133,276,3.33
078,White,30,Male,2.06,FALSE,152,131,283,2.82
1166,Asian,24,Male,2.47,FALSE,161,169,330,2.56
220,Black,21,Male,2.21,TRUE,140,131,271,3.11
1637,White,23,Female,3.94,FALSE,138,149,287,2.89
0743,White,22,Female,2.39,FALSE,148,140,288,2.38
0186,White,24,Female,3.32,FALSE,148,158,306,3.88
566,Black,26,Female,2.48,FALSE,143,154,297,3.08
364,White,20,Male,2.73,TRUE,135,158,293,3.5
1381,White,23,Female,1.37,FALSE,137,139,276,2.09
350,White,21,Trans*,2.86,TRUE,153,130,283,3.07
0607,Hispanic,30,Female,2.16,FALSE,146,140,286,3.93
1096,White,21,Female,3.69,FALSE,149,166,315,3.03
307,Black,20,Female,2.55,FALSE,141,132,273,2.41
0130,Black,21,Female,3.05,FALSE,143,135,278,3.54
287,Black,27,Trans*,2.35,FALSE,132,145,277,2.41
200,Hispanic,27,Male,2.24,TRUE,165,134,299,2.45
0380,White,25,Female,1.5,FALSE,151,154,305,2.78
542,Black,28,Trans*,2.39,FALSE,141,140,281,2.81
353,White,20,Male,2.5,FALSE,166,142,308,2.8
0744,White,28,Male,1.85,FALSE,148,137,285,2.9
1241,White,24,Trans*,1.33,FALSE,148,168,316,2.12
547,Black,24,Male,1.46,TRUE,159,149,308,3.89
371,Asian,27,Male,2.52,FALSE,138,134,272,1.91
330,White,20,Female,2.51,FALSE,144,147,291,2.48
1388,Asian,27,Trans*,3.01,FALSE,143,154,297,3.3
0495,Hispanic,22,Trans*,1.74,FALSE,149,161,310,3.17
1142,White,21,Female,1.32,FALSE,169,160,329,2.27
329,White,23,Male,2.55,FALSE,138,136,274,2.5
0573,White,30,Trans*,3.25,FALSE,133,152,285,3.99
361,White,26,Female,2.75,FALSE,139,144,283,3.32
0371,White,28,Male,2.14,FALSE,133,144,277,3.59
028,White,20,Female,2.41,FALSE,139,136,275,2.96
015,White,25,Trans*,2.24,TRUE,137,141,278,2.69
761,White,25,Trans*,2.84,TRUE,156,152,308,3.46
0749,White,21,Trans*,3.52,FALSE,138,157,295,2.8
453,White,29,Trans*,2.12,FALSE,141,135,276,3.26
1730,Bi-Racial,21,Male,2.14,FALSE,147,147,294,3.17
0605,White,25,Trans*,3.62,FALSE,151,146,297,2.74
0831,White,21,Female,3.05,FALSE,161,147,308,2.29
1369,White,21,Trans*,2.23,FALSE,134,166,300,2.65
1008,White,30,Male,2.04,FALSE,156,162,318,3.05
1520,Hispanic,21,Female,3.27,FALSE,147,163,310,3.45
0611,White,20,Trans*,3.75,FALSE,162,146,308,3.37
0656,White,30,Male,3.63,FALSE,139,152,291,2.84
1953,Asian,26,Trans*,3.36,FALSE,140,166,306,3.62
380,White,24,Male,1.91,FALSE,155,138,293,3.36
1874,Hispanic,26,Trans*,1.52,FALSE,142,167,309,2.65
0340,White,21,Female,1.43,FALSE,137,139,276,3.86
0215,White,23,Female,1.53,FALSE,137,160,297,3.69
003,Hispanic,25,Trans*,2.53,FALSE,155,130,285,3.27
130,White,29,Male,1.25,FALSE,136,135,271,2.18
398,White,25,Female,2.74,FALSE,139,130,269,3.82
159,White,27,Male,2.47,TRUE,147,145,292,3.67
038,White,20,Male,2.53,FALSE,137,136,273,2.96
762,Asian,25,Female,2.65,FALSE,151,132,283,2.35
1911,White,24,Trans*,3.78,FALSE,131,148,279,3.66
1270,White,20,Male,2.86,FALSE,152,134,286,2.45
415,White,22,Male,2.21,FALSE,153,143,296,2.23
1756,White,23,Male,3.91,FALSE,135,154,289,2.54
0756,White,24,Male,1.52,FALSE,144,157,301,3.15
187,Black,27,Female,2.34,TRUE,160,131,291,3.14
1778,Hispanic,22,Trans*,2.67,FALSE,141,156,297,2.91
1811,White,27,Trans*,2.14,FALSE,145,156,301,3.38
0761,White,30,Trans*,2.4,FALSE,153,136,289,3.69
1547,White,27,Female,3.61,FALSE,151,167,318,3.52
0066,Hispanic,22,Female,1.74,FALSE,149,138,287,3.26
0477,Hispanic,21,Female,1.72,FALSE,156,170,326,3.52
310,White,25,Trans*,2.46,FALSE,157,137,294,2.99
0757,Asian,26,Female,2.49,FALSE,147,149,296,3.36
0517,White,24,Male,1.08,FALSE,164,160,324,3.82
1032,Hispanic,22,Female,1.78,FALSE,152,150,302,3.84
1186,White,20,Male,2.24,FALSE,131,159,290,2.32
1555,White,23,Female,2.53,FALSE,146,140,286,2.99
428,White,28,Male,2.65,TRUE,140,132,272,3.35
0026,White,25,Male,1.25,FALSE,139,150,289,3.21
1233,Black,27,Trans*,2.78,FALSE,131,159,290,3.8
395,White,20,Female,1.95,FALSE,160,137,297,3.18
0976,White,27,Male,2.77,FALSE,130,154,284,3.93
1094,Black,23,Trans*,1.78,FALSE,131,166,297,2.74
164,White,28,Male,2.24,FALSE,150,131,281,2.59
160,White,28,Male,1.51,TRUE,158,135,293,3.06
0823,Black,20,Female,3.92,FALSE,150,159,309,3.35
0397,White,28,Trans*,1.76,FALSE,141,140,281,3.79
1271,White,28,Trans*,2.08,FALSE,143,142,285,3.51
677,White,24,Trans*,1.96,FALSE,151,134,285,3.51
1711,Hispanic,29,Trans*,2.1,FALSE,168,149,317,3.21
1451,White,29,Female,1.33,FALSE,138,169,307,3.15
1227,Hispanic,28,Female,1.92,FALSE,157,162,319,2.04
1687,White,24,Trans*,1.9,FALSE,157,143,300,2.57
0886,Hispanic,26,Male,2.12,FALSE,162,150,312,2.4
363,White,30,Male,2.78,FALSE,151,132,283,3.46
416,Hispanic,22,Male,2.75,FALSE,153,148,301,3.38
203,White,28,Male,1.8,FALSE,158,133,291,2.76
097,White,29,Male,2.32,FALSE,157,133,290,3.04
1091,White,30,Male,1.18,FALSE,143,151,294,3.7
741,White,29,Female,2.17,TRUE,133,152,285,3.6
1712,White,25,Male,3.3,FALSE,155,155,310,3.95
200,White,25,Male,2.44,FALSE,169,135,304,1.74
674,Black,29,Female,2.62,FALSE,155,143,298,3.45
341,Hispanic,30,Trans*,2.71,FALSE,147,143,290,2.98
1649,Hispanic,22,Female,3.15,FALSE,143,162,305,3.55
496,Hispanic,22,Female,2.63,FALSE,136,145,281,2.39
049,White,20,Female,1.99,FALSE,135,152,287,3.5
140,White,20,Male,3.77,FALSE,139,133,272,2.66
706,White,24,Male,2.59,FALSE,139,132,271,3.08
0366,Asian,29,Female,2.1,FALSE,165,130,295,3.75
213,Hispanic,21,Male,3.03,FALSE,145,130,275,2.5
526,White,28,Male,1.81,FALSE,152,132,284,3.87
0990,Black,24,Trans*,2.09,FALSE,138,139,277,3.34
573,Hispanic,26,Trans*,2.86,FALSE,140,132,272,3.13
349,Black,21,Female,2.48,TRUE,151,133,284,3.13
0106,White,20,Male,2.65,FALSE,152,156,308,2.68
600,White,23,Male,3.02,TRUE,142,131,273,3.92
1462,White,28,Male,2.27,FALSE,152,141,293,2.29
1516,White,29,Trans*,3.2,FALSE,139,154,293,3.63
0274,White,20,Trans*,1.55,FALSE,142,145,287,3.31
0899,White,24,Female,2.6,FALSE,141,148,289,3.88
334,White,25,Female,3,FALSE,135,141,276,2.96
0445,White,23,Male,3.09,FALSE,152,138,290,2.91
1414,White,23,Trans*,3.65,FALSE,141,136,277,2.42
0081,Hispanic,20,Female,1.88,FALSE,150,169,319,3.37
673,White,29,Female,3.44,FALSE,134,131,265,2.03
0515,Black,26,Female,2.17,FALSE,163,143,306,3.59
541,White,25,Male,1.75,FALSE,149,132,281,2.53
155,White,24,Female,2.03,FALSE,157,132,289,3.47
1821,White,30,Female,2.84,FALSE,139,147,286,2.92
0336,Asian,20,Trans*,2.42,FALSE,157,160,317,3.09
568,White,26,Female,3.27,TRUE,153,132,285,3.8
262,White,25,Trans*,2.82,TRUE,157,134,291,3.6
786,White,25,Trans*,2.01,FALSE,144,137,281,2.28
1221,Black,27,Trans*,3.63,FALSE,159,131,290,2.74
1624,White,28,Male,1.51,FALSE,164,136,300,3.52
1567,White,23,Trans*,2.03,FALSE,147,142,289,3.54
1454,White,22,Trans*,2.5,FALSE,149,146,295,2.62
0697,White,27,Trans*,2.5,FALSE,158,165,323,3.56
1866,White,23,Trans*,3.42,FALSE,139,169,308,3.34
0112,White,20,Male,1.79,FALSE,157,148,305,2.93
080,White,29,Female,3.05,FALSE,155,138,293,3.81
0134,White,28,Trans*,3.38,FALSE,144,152,296,2.44
0343,White,21,Trans*,3.73,FALSE,145,142,287,1.06
400,Asian,30,Trans*,1.59,FALSE,140,135,275,2.3
1822,White,30,Female,2.56,FALSE,163,162,325,3.61
034,White,30,Male,2.04,TRUE,137,137,274,3.47
382,White,21,Female,2.6,TRUE,153,145,298,3.73
0287,White,22,Female,1.59,FALSE,165,157,322,2.78
1742,White,23,Trans*,2.3,FALSE,139,147,286,3.85
1611,White,20,Trans*,2.38,FALSE,131,151,282,3.2
1734,White,20,Trans*,1.88,FALSE,155,139,294,3.37
0897,White,28,Male,1.9,FALSE,164,167,331,2.84
0617,Hispanic,24,Female,3.37,FALSE,153,155,308,3.34
180,White,29,Female,2.89,TRUE,148,130,278,2.8
0434,Hispanic,26,Male,1.01,FALSE,168,138,306,2.66
046,White,28,Male,2.59,FALSE,131,150,281,2.25
1496,Hispanic,25,Male,2.58,FALSE,163,165,328,3.19
739,Black,28,Trans*,1.52,FALSE,144,133,277,3.41
1131,White,25,Female,2.81,FALSE,134,146,280,1.78
1333,White,21,Female,3.36,FALSE,169,159,328,2.42
0398,White,24,Female,3.03,FALSE,140,156,296,3.93
1714,White,25,Female,3.66,FALSE,141,137,278,3.5
1833,White,30,Male,2.88,FALSE,150,157,307,3.72
441,Black,22,Male,2.76,TRUE,145,134,279,3.69
0737,White,23,Male,3.41,FALSE,142,155,297,3.91
735,White,24,Female,2.15,TRUE,136,132,268,3.12
1230,Hispanic,28,Male,1.2,FALSE,131,157,288,2.49
735,White,22,Trans*,3.73,FALSE,162,149,311,3.3
071,White,29,Male,1.45,TRUE,143,131,274,3.18
708,White,23,Male,2.77,FALSE,142,142,284,3.26
1655,Hispanic,24,Male,3.13,FALSE,157,136,293,2.61
001,Bi-Racial,23,Trans*,2.5,FALSE,167,132,299,2.92
0443,White,24,Male,1.21,FALSE,141,133,274,3.47
320,White,29,Female,2.36,FALSE,167,145,312,2.25
1970,White,21,Trans*,1.26,FALSE,151,155,306,2.74
0326,White,26,Trans*,1.56,FALSE,141,131,272,3.2
123,White,24,Trans*,2.68,FALSE,152,132,284,3.11
338,White,22,Male,2.82,TRUE,138,156,294,3.45
0453,Hispanic,26,Trans*,3.3,FALSE,155,143,298,2.09
1404,White,21,Trans*,3.11,FALSE,151,153,304,3.45
1442,White,25,Male,2.81,FALSE,169,158,327,2.31
1654,White,27,Female,2.82,FALSE,132,161,293,3.94
0041,White,25,Trans*,1.39,FALSE,136,146,282,3.28
1395,White,27,Female,3.47,FALSE,143,150,293,2.59
430,White,22,Trans*,1.82,TRUE,146,131,277,2.55
1575,White,30,Male,2.93,FALSE,144,141,285,1.78
0471,Bi-Racial,27,Female,1.56,FALSE,130,144,274,3.42
0271,White,28,Male,1.66,FALSE,154,154,308,3.85
1636,Asian,22,Male,3.27,FALSE,151,149,300,2.51
633,White,28,Trans*,3.12,TRUE,149,133,282,3.26
1195,Asian,25,Female,3.46,FALSE,149,145,294,2.45
1320,White,22,Male,3.44,FALSE,135,142,277,3.55
282,White,24,Female,2.59,FALSE,166,139,305,2.45
1010,Hispanic,20,Trans*,2.28,FALSE,139,132,271,3.61
0253,White,27,Trans*,3.9,FALSE,149,148,297,2.88
745,White,23,Trans*,2.74,TRUE,148,132,280,3.2
1169,White,25,Trans*,3.97,FALSE,154,160,314,1.65
0682,White,21,Trans*,1.05,FALSE,141,151,292,1.46
696,Hispanic,27,Female,2.12,FALSE,139,149,288,2.89
1488,White,24,Male,3.46,FALSE,143,163,306,3.16
1030,Black,23,Trans*,1.1,FALSE,153,164,317,2.79
1616,White,24,Male,1.96,FALSE,150,146,296,2.71
452,Hispanic,23,Female,2.45,TRUE,137,131,268,3.41
0155,Hispanic,29,Male,1.55,FALSE,159,155,314,3.99
1733,Hispanic,23,Trans*,3.89,FALSE,139,156,295,2.77
0456,White,27,Trans*,2.05,FALSE,146,147,293,2.66
1198,White,28,Trans*,3.09,FALSE,162,167,329,1.81
469,White,23,Trans*,2.71,TRUE,150,136,286,3.29
141,White,29,Trans*,3.01,FALSE,131,132,263,3.12
0333,Black,25,Trans*,2.26,FALSE,133,165,298,3.75
0202,White,21,Female,2.97,FALSE,141,149,290,3.53
1559,White,20,Female,2.21,FALSE,131,155,286,3.15
433,White,20,Trans*,2.97,TRUE,143,150,293,3.61
0788,Hispanic,25,Trans*,3.18,FALSE,134,164,298,2.58
0762,White,27,Male,1.61,FALSE,159,169,328,1.8
0534,White,25,Female,3.06,FALSE,144,139,283,3.48
1443,White,22,Female,2.25,FALSE,165,147,312,3.06
1228,White,20,Female,1.57,FALSE,151,149,300,3.27
427,White,23,Male,1.97,TRUE,139,136,275,2.91
547,White,28,Female,1.87,FALSE,163,142,305,2.28
1672,White,25,Female,1.68,FALSE,142,155,297,3.76
704,White,28,Female,2.77,TRUE,154,153,307,3.3
0432,Hispanic,22,Female,1.81,FALSE,145,157,302,3.35
0717,White,28,Trans*,3.41,FALSE,139,132,271,3.47
1900,White,27,Female,1.21,FALSE,151,166,317,3.38
753,White,30,Female,3.34,TRUE,155,148,303,3.32
606,Hispanic,29,Male,2.4,FALSE,153,149,302,3.18
1061,Asian,24,Female,2.58,FALSE,131,137,268,2.99
1076,Black,30,Trans*,1.06,FALSE,147,163,310,3.53
626,White,29,Male,3.28,FALSE,142,135,277,3.07
545,Hispanic,26,Trans*,2.68,TRUE,165,132,297,3.61
1309,Asian,28,Female,2.51,FALSE,152,159,311,2.24
1162,White,29,Trans*,1.81,FALSE,161,162,323,2.95
1362,Hispanic,21,Male,1.58,FALSE,135,169,304,2.29
644,Hispanic,21,Male,1.9,FALSE,148,131,279,2.69
559,White,28,Male,3.08,TRUE,162,148,310,3.24
0729,White,25,Female,2.58,FALSE,159,157,316,1.21
0850,White,24,Trans*,1.84,FALSE,164,131,295,3.96
1199,White,27,Trans*,2.19,FALSE,138,144,282,3.06
570,White,30,Trans*,2.39,TRUE,163,143,306,3.73
1966,Hispanic,26,Male,1.34,FALSE,142,160,302,3.67
0507,White,24,Trans*,1.4,FALSE,145,170,315,1.08
1197,Black,30,Male,3,FALSE,152,164,316,3.8
1502,Black,28,Female,2.47,FALSE,144,162,306,3.01
0110,White,27,Male,3.93,FALSE,132,150,282,3.98
286,White,27,Trans*,2.25,TRUE,146,132,278,3.27
1858,White,27,Trans*,3.42,FALSE,131,147,278,3.22
0840,Asian,30,Female,3.15,FALSE,132,165,297,2.86
605,White,30,Male,2.37,TRUE,138,131,269,3.15
0771,White,26,Female,2.27,FALSE,140,138,278,3.35
0040,Black,20,Trans*,1.73,FALSE,160,147,307,3.58
793,Hispanic,23,Female,1.68,TRUE,151,148,299,3.47
609,White,20,Female,1.84,TRUE,148,153,301,3.67
791,Hispanic,26,Male,2.18,TRUE,149,132,281,3.83
0745,White,29,Male,1.6,FALSE,146,152,298,2.09
632,White,20,Female,1.5,TRUE,166,131,297,3.34
413,Asian,25,Trans*,1.98,TRUE,167,135,302,3.74
760,White,29,Trans*,2.67,TRUE,152,141,293,3.84
0303,White,28,Male,2.24,FALSE,150,153,303,2.19
670,Hispanic,23,Trans*,3.09,TRUE,145,131,276,3.4
637,White,29,Male,2.44,TRUE,134,138,272,3.51
0474,Hispanic,20,Male,2.74,FALSE,144,169,313,3.63
588,White,28,Trans*,2.96,FALSE,155,131,286,2.4
1251,White,29,Female,3.23,FALSE,138,148,286,2.73
1537,White,29,Male,3.95,FALSE,151,130,281,2.8
202,White,26,Female,2,FALSE,151,135,286,3
055,White,22,Trans*,2.19,TRUE,141,139,280,2.3
194,Black,30,Trans*,2.66,TRUE,158,130,288,2.96
1171,White,26,Female,1.64,FALSE,158,137,295,3.55
0200,White,22,Male,2.13,FALSE,154,160,314,2.89
068,Black,21,Female,2.48,FALSE,154,141,295,2.44
1344,Hispanic,26,Male,3.56,FALSE,150,161,311,1.97
027,White,20,Male,2.48,FALSE,165,139,304,2.51
1867,White,22,Female,1.85,FALSE,155,163,318,3.21
625,White,23,Trans*,3.57,FALSE,166,136,302,3.57
1133,White,26,Female,2.73,FALSE,151,166,317,3.79
0589,Black,25,Trans*,2,FALSE,146,153,299,2.58
1153,Bi-Racial,23,Female,2.73,FALSE,138,150,288,3.48
691,Black,28,Female,2.31,TRUE,136,138,274,3.09
317,White,23,Female,1.92,TRUE,151,134,285,3.91
339,Asian,23,Trans*,3.45,FALSE,146,132,278,2.33
370,White,27,Male,2.22,FALSE,142,146,288,2.99
0143,White,30,Female,1.72,FALSE,132,169,301,3.73
1921,White,23,Trans*,2.46,FALSE,158,130,288,2.96
0732,Hispanic,25,Female,3.83,FALSE,153,158,311,1.51
1868,Native,27,Female,2.5,FALSE,153,143,296,3.26
0781,White,20,Trans*,3.02,FALSE,164,155,319,3.76
1863,White,27,Female,1.53,FALSE,135,147,282,2.92
230,White,21,Male,2.1,TRUE,143,131,274,3.78
0165,White,22,Trans*,1.95,FALSE,156,156,312,3.3
229,White,22,Female,2.37,TRUE,134,136,270,2.45
1784,White,26,Female,1.19,FALSE,139,153,292,3.31
0654,White,21,Female,1.71,FALSE,159,167,326,2.23
368,White,28,Female,2.35,FALSE,132,130,262,2.38
0929,White,26,Female,3.79,FALSE,145,154,299,3.76
1506,White,30,Female,3.08,FALSE,145,156,301,2.49
1074,Hispanic,30,Female,1.33,FALSE,142,155,297,3.77
342,White,26,Male,2.56,TRUE,153,132,285,2.8
0377,Black,24,Male,1.47,FALSE,151,131,282,2.01
1489,White,25,Trans*,1.69,FALSE,157,155,312,3.62
362,White,30,Male,2.19,FALSE,166,138,304,2.64
0819,Hispanic,23,Female,1.79,FALSE,133,159,292,3.75
305,White,20,Female,2.52,FALSE,156,135,291,3.29
1557,White,26,Male,1.99,FALSE,156,166,322,3.11
1350,White,27,Trans*,3.4,FALSE,144,150,294,3
0841,White,23,Male,1.52,FALSE,133,148,281,1.27
515,White,26,Trans*,2.97,FALSE,144,135,279,2.34
442,Hispanic,24,Male,2.79,FALSE,139,133,272,2.78
0157,Asian,21,Male,2.67,FALSE,147,158,305,2.92
0862,White,24,Male,3.04,FALSE,146,158,304,3.69
487,Hispanic,24,Trans*,2.82,TRUE,131,131,262,3.33
0855,White,30,Trans*,1.79,FALSE,133,138,271,2.26
1393,White,23,Trans*,3.36,FALSE,150,165,315,2.27
1716,Black,29,Female,2.02,FALSE,149,144,293,2.6
1281,White,23,Female,2.88,FALSE,162,154,316,3.84
007,White,26,Female,3.4,TRUE,149,134,283,2.7
297,Hispanic,29,Female,1.56,TRUE,150,140,290,2.99
775,White,29,Trans*,2.04,TRUE,140,131,271,3.24
143,White,26,Trans*,2.78,TRUE,166,131,297,3.47
541,White,21,Female,3.24,TRUE,159,141,300,3.36
221,White,20,Trans*,2.14,FALSE,166,141,307,3.2
537,Hispanic,21,Male,2.11,TRUE,155,133,288,3.68
520,Hispanic,22,Trans*,2.26,FALSE,145,136,281,2.98
0074,White,28,Female,3.35,FALSE,151,154,305,1.9
118,White,27,Male,2.54,TRUE,151,152,303,3.48
211,White,29,Trans*,2.38,TRUE,144,130,274,2.67
1659,White,28,Female,2.16,FALSE,149,157,306,3.31
724,White,24,Trans*,2.86,TRUE,154,132,286,3.48
387,Hispanic,20,Trans*,3.24,TRUE,148,131,279,3.18
0235,White,28,Female,1.69,FALSE,145,138,283,3.29
1799,Hispanic,30,Male,1.48,FALSE,144,139,283,3.13
749,White,21,Male,1.35,TRUE,133,132,265,2.95
725,Asian,29,Trans*,2.82,FALSE,151,138,289,2.52
0306,White,23,Trans*,1.82,FALSE,133,134,267,1.59
1603,White,23,Female,2.85,FALSE,159,142,301,3.24
539,Hispanic,20,Female,2.73,TRUE,135,135,270,3.02
449,White,29,Male,2.58,FALSE,150,140,290,3.3
477,Black,28,Female,2.68,FALSE,142,135,277,3.56
088,White,22,Female,2.32,TRUE,142,148,290,2.82
085,White,28,Female,2.07,FALSE,161,131,292,2.67
122,Black,27,Male,1.45,TRUE,155,131,286,3.44
197,White,28,Female,2.46,FALSE,152,141,293,2.74
059,White,21,Female,2.1,FALSE,130,131,261,3.06
308,Native,30,Trans*,1.92,TRUE,159,136,295,3.85
0294,Black,20,Trans*,3.83,FALSE,146,170,316,2.65
399,White,23,Male,2.66,FALSE,142,133,275,2.89
268,White,27,Trans*,2.12,FALSE,133,150,283,1.76
1214,Black,27,Male,3.03,FALSE,149,167,316,2.43
598,White,25,Male,2.71,FALSE,132,141,273,3.32
1503,White,28,Trans*,3.55,FALSE,149,168,317,1.93
0755,Hispanic,27,Female,3.42,FALSE,132,139,271,2.9
318,White,26,Female,2.69,FALSE,135,131,266,3.23
594,White,29,Male,2.42,TRUE,146,146,292,3.95
598,Hispanic,23,Male,2.82,TRUE,144,133,277,3.43
115,White,28,Trans*,1.82,TRUE,138,131,269,3.71
759,White,22,Female,2.42,FALSE,136,131,267,3.56
1468,White,22,Male,3.89,FALSE,139,133,272,2.37
083,White,26,Male,2.18,FALSE,135,137,272,2.59
1492,Hispanic,21,Female,2.1,FALSE,164,154,318,2.74
1022,White,28,Trans*,1.81,FALSE,147,156,303,2.14
202,White,21,Female,2.22,TRUE,143,133,276,3.37
333,White,23,Male,1.9,FALSE,169,131,300,2.95
1164,Black,30,Male,3.41,FALSE,162,165,327,3.42
0107,White,26,Male,1.63,FALSE,149,164,313,3.68
654,White,27,Trans*,2.36,TRUE,141,132,273,2.97
1373,White,21,Trans*,3.27,FALSE,157,150,307,2.57
0797,White,26,Female,3.57,FALSE,152,157,309,2.95
468,White,24,Trans*,2.3,FALSE,153,136,289,2.89
232,White,20,Trans*,2.08,TRUE,144,134,278,3.31
051,White,25,Female,2.2,TRUE,135,134,269,2.76
1448,Hispanic,25,Female,2.61,FALSE,138,154,292,3.79
1463,White,22,Female,1.36,FALSE,153,158,311,3.32
393,Black,27,Male,2.61,FALSE,148,135,283,2.67
030,White,25,Trans*,1.82,FALSE,155,148,303,2.89
1524,White,22,Female,1.18,FALSE,160,142,302,2.99
1207,White,24,Female,1.1,FALSE,161,144,305,3.6
766,White,22,Female,2.32,FALSE,164,136,300,2.9
030,White,20,Male,2.8,TRUE,132,132,264,2.15
109,White,20,Trans*,2.46,TRUE,142,147,289,3.58
435,White,22,Female,2.39,TRUE,141,144,285,2.64
744,White,29,Male,1.84,FALSE,142,135,277,3.81
1125,White,29,Trans*,2.41,FALSE,132,132,264,3.79
1258,White,29,Trans*,1.52,FALSE,148,167,315,3
492,Black,25,Trans*,2.5,FALSE,154,141,295,3.2
319,White,25,Female,2.17,TRUE,137,133,270,3.17
0543,Black,29,Male,1.04,FALSE,162,132,294,3.83
111,Hispanic,22,Female,2.27,TRUE,159,133,292,3.82
1242,White,28,Female,1.19,FALSE,134,163,297,3.07
259,White,26,Female,2.18,FALSE,141,144,285,2.48
1884,White,23,Trans*,2.28,FALSE,138,158,296,3.01
299,White,30,Trans*,3.19,FALSE,133,135,268,2.51
540,White,28,Male,2.14,TRUE,153,133,286,3.52
0309,White,20,Female,2,FALSE,152,146,298,3.49
0700,White,26,Female,3.91,FALSE,135,162,297,1.67
596,White,26,Female,2.56,FALSE,159,144,303,2.1
1112,White,27,Trans*,2.66,FALSE,134,151,285,2.71
0288,Asian,24,Trans*,3.3,FALSE,150,160,310,3
305,Asian,24,Male,2.47,TRUE,141,143,284,1.88
505,White,26,Trans*,1.81,FALSE,146,139,285,2.63
0557,White,28,Male,3.11,FALSE,130,147,277,3.22
0286,White,24,Trans*,1.48,FALSE,147,169,316,1.53
0022,Hispanic,22,Male,2.24,FALSE,144,138,282,2.43
1780,White,24,Female,1.69,FALSE,150,164,314,3.57
543,White,25,Female,3.18,FALSE,138,143,281,3.77
1593,White,28,Male,2.58,FALSE,153,169,322,3.96
504,White,20,Male,2.55,FALSE,149,141,290,3.19
0018,White,26,Trans*,2.54,FALSE,160,158,318,3.33
1187,White,24,Trans*,2.01,FALSE,166,149,315,2.29
320,Black,24,Trans*,3.01,TRUE,138,131,269,2.9
1190,White,21,Trans*,1.38,FALSE,141,150,291,3.56
0179,White,23,Female,3.07,FALSE,141,144,285,3.48
1426,Black,20,Male,2.21,FALSE,132,161,293,3.8
409,White,26,Male,1.72,FALSE,159,136,295,2.65
0169,White,20,Trans*,3,FALSE,157,131,288,3.34
1546,White,25,Male,2.68,FALSE,142,148,290,3.2
0695,Hispanic,27,Trans*,1.48,FALSE,159,161,320,3.8
0885,White,29,Female,2.41,FALSE,130,157,287,3.47
0867,White,29,Male,1.45,FALSE,144,150,294,3.18
231,Hispanic,22,Female,1.61,TRUE,131,130,261,3.3
0835,White,23,Female,2.25,FALSE,139,146,285,3.76
1110,White,29,Male,3.53,FALSE,136,164,300,3.66
0089,White,20,Female,1.97,FALSE,132,151,283,3.12
091,White,27,Female,2.39,TRUE,135,143,278,3.17
1398,White,20,Female,3.34,FALSE,155,160,315,2.39
1500,White,22,Female,1.7,FALSE,152,149,301,3.13
592,Black,28,Female,3.04,FALSE,158,141,299,3.04
1132,Black,29,Male,3.78,FALSE,145,159,304,3.71
1289,White,26,Male,1.6,FALSE,135,158,293,3.33
296,Hispanic,23,Trans*,2.42,TRUE,135,134,269,3.27
742,Black,29,Trans*,2.95,FALSE,155,131,286,2.9
1109,White,23,Female,2.47,FALSE,148,169,317,3.22
738,Black,22,Trans*,1.79,TRUE,152,139,291,2.7
563,Hispanic,21,Trans*,3.39,TRUE,153,131,284,3.28
1589,White,27,Male,3.29,FALSE,156,144,300,2.65
1047,White,29,Female,3.16,FALSE,146,168,314,3.59
757,Hispanic,29,Male,3.07,TRUE,144,134,278,2.53
513,Black,26,Male,3.23,FALSE,142,132,274,3.25
1841,Black,24,Female,2.1,FALSE,145,158,303,3.98
431,White,29,Male,1.88,FALSE,157,131,288,2.04
1768,White,23,Male,2.67,FALSE,147,159,306,2.92
1763,Hispanic,24,Female,2.33,FALSE,148,164,312,3.25
1267,Hispanic,23,Trans*,3.14,FALSE,134,153,287,3.21
0050,Black,30,Female,2.82,FALSE,142,148,290,3.84
130,White,23,Female,2.71,TRUE,158,139,297,3.48
1614,White,25,Trans*,2.13,FALSE,150,154,304,2.67
0334,White,28,Female,2.89,FALSE,137,138,275,3.02
1456,Hispanic,26,Trans*,1.73,FALSE,143,144,287,2.33
753,Native,30,Female,2.29,FALSE,156,131,287,3.44
142,White,25,Female,3.15,FALSE,136,134,270,3.33
676,Hispanic,24,Female,2.88,FALSE,143,130,273,3.39
0289,White,24,Trans*,2.1,FALSE,149,143,292,2.88
653,Black,22,Female,1.77,TRUE,156,133,289,2.96
684,White,21,Trans*,2.99,FALSE,149,131,280,3.25
1342,White,27,Female,1.9,FALSE,158,145,303,3.45
0255,White,24,Female,3.92,FALSE,139,135,274,3.68
0578,White,30,Female,2.61,FALSE,140,168,308,2.9
297,White,20,Trans*,3,FALSE,149,133,282,2.49
1678,White,29,Male,3,FALSE,135,142,277,3.28
1643,White,22,Trans*,2.44,FALSE,145,168,313,1.88
1563,White,30,Trans*,3.8,FALSE,146,144,290,3.92
695,White,30,Female,2.39,FALSE,132,151,283,2.46
0568,White,28,Trans*,1.55,FALSE,156,131,287,2.54
0938,Asian,22,Female,2.01,FALSE,143,167,310,1.95
126,Hispanic,21,Male,2.5,FALSE,131,131,262,3.28
1286,Hispanic,20,Male,2.53,FALSE,150,151,301,3.24
146,White,25,Female,2.23,TRUE,147,140,287,3.66
0972,Hispanic,24,Trans*,3.32,FALSE,138,138,276,3.81
401,White,23,Trans*,1.82,FALSE,132,131,263,3.26
0790,White,27,Male,2.89,FALSE,136,150,286,3.31
1685,White,30,Female,3.24,FALSE,149,157,306,3.51
1290,White,24,Male,1.96,FALSE,144,165,309,3.1
1004,White,22,Trans*,3.17,FALSE,143,147,290,3.82
655,White,29,Male,2.58,FALSE,145,138,283,3.77
172,White,24,Trans*,2.06,TRUE,159,131,290,3.43
726,Bi-Racial,24,Trans*,1.68,TRUE,150,139,289,3.62
407,White,28,Female,2.64,FALSE,130,135,265,3.07
0890,White,24,Trans*,1.05,FALSE,158,141,299,3.25
0595,White,21,Trans*,2.68,FALSE,156,130,286,3.48
092,Black,22,Female,2.67,TRUE,165,141,306,2.51
1909,White,25,Female,2,FALSE,137,152,289,2.07
239,White,21,Trans*,2.06,FALSE,144,137,281,1.32
0494,White,25,Male,3.98,FALSE,168,168,336,3.25
150,White,24,Male,2,FALSE,143,135,278,2.73
0650,Black,27,Female,3.24,FALSE,140,151,291,3.09
755,White,27,Female,2.07,FALSE,131,133,264,3.42
1256,White,26,Female,2.84,FALSE,161,154,315,2.9
1183,White,26,Female,3.72,FALSE,154,151,305,2.54
678,Black,22,Trans*,2.97,TRUE,130,142,272,2.69
062,White,26,Female,2.95,FALSE,155,135,290,3.05
1602,White,20,Male,2.08,FALSE,164,136,300,3.43
1893,White,25,Male,2.14,FALSE,150,168,318,3.58
1085,White,27,Trans*,3.26,FALSE,166,159,325,2.31
0256,Black,21,Trans*,1.01,FALSE,148,160,308,1.67
527,White,21,Female,2.52,TRUE,150,139,289,2.76
0942,Hispanic,20,Female,1.12,FALSE,156,168,324,3.03
012,White,20,Female,2.48,FALSE,139,147,286,2.83
0379,White,25,Female,1.61,FALSE,161,167,328,2.94
098,White,29,Male,2.86,TRUE,153,143,296,3.81
041,White,22,Female,3.19,FALSE,154,136,290,2.93
1037,White,30,Trans*,3.28,FALSE,153,159,312,3.05
0229,Hispanic,22,Male,1.41,FALSE,155,169,324,2.38
371,Bi-Racial,27,Male,2.91,TRUE,145,139,284,3.35
1731,Black,20,Male,2.56,FALSE,157,151,308,3.45
1294,Hispanic,29,Trans*,1.95,FALSE,131,147,278,2.66
0551,White,24,Female,1.8,FALSE,169,154,323,3.45
1377,Asian,22,Male,2.74,FALSE,143,156,299,2.13
0272,Black,28,Trans*,2.37,FALSE,152,144,296,3.53
358,Asian,23,Trans*,2.46,FALSE,161,132,293,3.19
665,Hispanic,23,Female,2.44,FALSE,143,131,274,3.05
574,Hispanic,30,Trans*,1.9,TRUE,134,131,265,3.55
0587,White,22,Male,2.56,FALSE,141,138,279,3.63
719,Bi-Racial,24,Female,3.23,TRUE,156,155,311,3.4
0509,White,22,Trans*,2.72,FALSE,130,151,281,1.78
1146,White,26,Trans*,2.65,FALSE,155,131,286,2.91
493,White,25,Male,3.19,FALSE,142,137,279,2.87
0447,White,20,Trans*,2.86,FALSE,133,152,285,2.46
288,White,22,Male,2.31,FALSE,142,135,277,2.74
1406,White,27,Male,3.29,FALSE,138,151,289,3.48
1695,White,21,Male,1.17,FALSE,149,134,283,2.34
0526,Asian,29,Female,2.24,FALSE,138,131,269,2.1
529,White,23,Male,2.57,FALSE,143,140,283,2.37
1881,White,29,Trans*,3.38,FALSE,165,155,320,2.56
0304,Hispanic,22,Trans*,3.11,FALSE,150,169,319,3.05
415,Black,29,Trans*,3.14,TRUE,160,135,295,3.26
0240,White,25,Female,3.51,FALSE,152,146,298,1.85
1229,Hispanic,27,Trans*,2.45,FALSE,138,163,301,3.09
1786,White,24,Female,3.13,FALSE,135,164,299,2.88
0784,White,22,Male,2.8,FALSE,137,138,275,3.16
733,White,28,Female,3.32,FALSE,145,130,275,2.94
1439,White,29,Female,3.3,FALSE,143,141,284,1.63
330,Black,24,Female,2.31,TRUE,147,132,279,3.59
651,White,29,Trans*,2.58,TRUE,155,136,291,3.51
245,Bi-Racial,28,Male,2.97,TRUE,164,149,313,3.5
0322,White,26,Female,1.5,FALSE,146,158,304,3.01
354,Hispanic,25,Female,3.42,TRUE,148,152,300,3.35
1662,Hispanic,30,Male,2.04,FALSE,156,154,310,3.66
0872,Hispanic,25,Female,3.05,FALSE,143,146,289,2.29
0580,Hispanic,25,Female,1.98,FALSE,154,157,311,3.51
416,White,25,Female,3.14,TRUE,138,138,276,3.2
0796,Native,22,Female,1.44,FALSE,143,151,294,3.74
006,Hispanic,25,Trans*,3.06,TRUE,161,137,298,3.16
0260,Black,26,Trans*,2.93,FALSE,140,158,298,2.64
439,Hispanic,28,Female,2.41,TRUE,132,131,263,3.65
576,White,25,Female,2.8,TRUE,152,148,300,2.79
0612,White,28,Female,1.73,FALSE,136,134,270,3.06
1913,Black,26,Trans*,3.19,FALSE,158,165,323,3.39
275,White,25,Male,2.51,FALSE,151,142,293,2.27
1762,White,26,Female,3.88,FALSE,161,160,321,2.63
666,White,23,Female,2.91,FALSE,155,132,287,2.3
675,Black,26,Female,3.24,FALSE,144,145,289,3.02
607,Black,26,Trans*,2.07,TRUE,148,148,296,3.34
1206,Hispanic,28,Male,2.37,FALSE,150,161,311,2.94
153,White,25,Male,3.51,TRUE,150,133,283,3.3
0935,White,26,Trans*,3.37,FALSE,130,143,273,3.5
1417,White,20,Female,3.48,FALSE,134,149,283,2.75
408,White,21,Female,2.42,TRUE,132,132,264,3.01
0113,White,28,Trans*,2.75,FALSE,144,157,301,3.4
0651,White,29,Female,2.83,FALSE,142,136,278,3.72
0425,White,23,Male,1.51,FALSE,161,153,314,3.3
1437,Hispanic,28,Male,3.16,FALSE,155,160,315,2.67
1533,Hispanic,25,Male,1.79,FALSE,156,145,301,3.06
0176,Asian,28,Trans*,3.93,FALSE,162,134,296,2.51
0683,White,27,Trans*,3.61,FALSE,146,133,279,2.88
0115,Asian,23,Male,3.5,FALSE,153,134,287,2.71
603,White,30,Trans*,3.03,TRUE,133,134,267,3.28
201,Black,25,Female,1.75,FALSE,162,142,304,2.02
1392,White,21,Male,3.45,FALSE,151,153,304,3.9
236,White,24,Male,2.61,FALSE,161,141,302,2.95
057,White,28,Male,1.5,TRUE,159,130,289,3.5
1104,Black,26,Male,1.05,FALSE,135,152,287,2.67
0424,Hispanic,20,Trans*,2.14,FALSE,137,142,279,2.75
1408,White,27,Female,1.87,FALSE,144,162,306,3.18
553,Hispanic,20,Trans*,2.89,TRUE,152,133,285,3.24
652,Hispanic,21,Male,2.84,TRUE,137,133,270,2.52
597,White,25,Trans*,2.76,FALSE,162,145,307,3.02
0713,White,28,Trans*,2.67,FALSE,133,159,292,3.79
0510,Hispanic,21,Male,2.35,FALSE,144,165,309,3.7
492,Hispanic,25,Male,1.99,TRUE,153,130,283,2.49
1338,Bi-Racial,23,Trans*,2.79,FALSE,167,158,325,3.06
1017,White,30,Trans*,1.89,FALSE,158,138,296,3.98
1154,Black,22,Trans*,1.98,FALSE,152,145,297,3.4
747,White,25,Female,2.04,TRUE,143,136,279,2.53
0724,Hispanic,30,Female,2.56,FALSE,155,160,315,3.18
1312,White,28,Male,3.01,FALSE,132,161,293,3.1
725,White,29,Trans*,2.74,TRUE,137,131,268,3.62
0690,Hispanic,20,Trans*,2.26,FALSE,140,135,275,3.72
0968,White,20,Male,1.57,FALSE,135,146,281,2.57
702,White,26,Female,3.49,TRUE,139,135,274,3.69
0146,White,28,Trans*,3.49,FALSE,135,155,290,3.91
147,Black,21,Trans*,2.76,FALSE,161,134,295,2.44
1250,White,27,Male,3.98,FALSE,137,143,280,2.8
0657,Hawaiian,23,Trans*,3.81,FALSE,131,153,284,3.62
192,Hispanic,26,Male,2.76,FALSE,162,136,298,2.67
086,White,21,Male,2.63,FALSE,135,141,276,2.55
1324,White,20,Trans*,2.59,FALSE,163,169,332,1.58
1160,White,20,Male,1.83,FALSE,162,137,299,1.6
1721,Asian,25,Female,2.13,FALSE,148,170,318,2.67
0201,White,27,Trans*,3.84,FALSE,157,163,320,3.54
1564,Asian,25,Female,3.85,FALSE,162,148,310,3.18
112,White,25,Male,2.92,FALSE,166,144,310,2.14
0197,White,26,Male,2.17,FALSE,155,157,312,3.75
0188,Bi-Racial,25,Female,1.28,FALSE,138,145,283,3.83
100,Hispanic,22,Trans*,3.11,TRUE,146,134,280,3.41
1627,White,30,Female,2.57,FALSE,135,160,295,2.96
0061,Hispanic,20,Female,1.74,FALSE,153,134,287,2.63
332,Black,24,Trans*,1.67,TRUE,159,140,299,3.82
0149,White,23,Male,1.31,FALSE,148,146,294,3.56
0673,Bi-Racial,28,Male,2.27,FALSE,157,165,322,2.84
0958,Native,23,Trans*,2.59,FALSE,149,156,305,3.98
426,White,28,Male,3.15,TRUE,143,146,289,2.99
135,Black,21,Trans*,2.04,TRUE,150,139,289,2.54
0950,White,29,Trans*,1.35,FALSE,155,164,319,2.43
530,White,25,Female,2.49,FALSE,151,131,282,3.44
0345,White,26,Trans*,1.23,FALSE,140,148,288,3.75
1155,White,30,Male,3.55,FALSE,147,169,316,2.58
1509,Hispanic,21,Male,1.36,FALSE,145,152,297,3.64
1494,Black,21,Male,2.39,FALSE,136,158,294,2.8
516,White,24,Trans*,1.2,FALSE,141,142,283,3.01
0217,Black,30,Male,1.02,FALSE,152,144,296,2.83
682,White,21,Male,2.01,FALSE,167,141,308,2.44
479,White,25,Female,2.22,FALSE,132,134,266,3.17
275,White,22,Trans*,2.8,TRUE,158,138,296,3.26
0020,Hispanic,27,Male,3.94,FALSE,152,163,315,3.67
1981,Black,28,Trans*,3.95,FALSE,140,154,294,3.08
697,White,28,Female,2.04,FALSE,160,131,291,3.34
173,Hispanic,26,Female,2.98,TRUE,152,131,283,3.37
252,White,24,Female,3.29,TRUE,144,133,277,3.29
238,White,20,Male,2.5,TRUE,139,134,273,3.15
139,White,21,Male,2,TRUE,161,142,303,2.61
249,Asian,26,Female,2.44,FALSE,146,138,284,2.51
1813,White,26,Female,2.52,FALSE,157,134,291,3.66
346,Asian,25,Female,2.62,FALSE,159,130,289,2.97
0520,White,30,Male,2.72,FALSE,144,151,295,3.34
0158,White,23,Female,2.76,FALSE,163,137,300,3.29
0233,Hispanic,26,Female,1.28,FALSE,132,157,289,3.78
0918,White,24,Male,2.32,FALSE,153,163,316,3.54
1585,White,26,Female,3.42,FALSE,150,155,305,2.74
1920,White,21,Trans*,1.86,FALSE,134,144,278,1.86
0144,White,27,Trans*,3.25,FALSE,136,137,273,2.12
542,White,27,Male,3.04,TRUE,157,137,294,3.66
1234,White,20,Trans*,2.08,FALSE,132,148,280,3.59
0072,Hispanic,29,Trans*,2,FALSE,161,153,314,1.8
1471,White,25,Trans*,2.81,FALSE,165,151,316,2.2
0956,White,28,Female,2.8,FALSE,131,132,263,2.39
0921,White,20,Trans*,1.51,FALSE,143,136,279,3.39
531,White,27,Trans*,1.78,TRUE,155,136,291,2.87
615,Black,20,Male,2.11,FALSE,134,138,272,3.21
0354,White,25,Trans*,2.32,FALSE,162,165,327,3.7
1396,White,29,Male,1.16,FALSE,155,154,309,3.94
1100,Black,23,Female,1.63,FALSE,138,134,272,3.3
139,Black,25,Trans*,2.5,FALSE,160,134,294,2.4
0971,Hispanic,24,Female,2.16,FALSE,152,148,300,3.39
1804,White,27,Trans*,2.15,FALSE,133,167,300,3.36
390,White,22,Trans*,2.8,FALSE,143,136,279,2.97
451,White,21,Trans*,2.15,TRUE,152,139,291,3.54
444,White,23,Female,2.26,TRUE,161,130,291,3.86
475,White,22,Male,2.2,TRUE,153,137,290,3.23
457,White,25,Female,2.81,TRUE,165,155,320,3.4
0640,White,26,Female,3.9,FALSE,164,155,319,1.48
681,Asian,29,Female,2.54,FALSE,140,131,271,3.13
428,White,29,Trans*,2.64,FALSE,152,144,296,3.26
574,White,23,Male,2.22,FALSE,144,140,284,3.08
1907,White,21,Female,3.46,FALSE,168,150,318,2.92
0481,Hispanic,27,Trans*,3.46,FALSE,131,165,296,3.49
035,White,21,Male,2.84,FALSE,139,137,276,2.45
0997,White,28,Trans*,3.36,FALSE,147,153,300,3.83
1963,White,30,Male,3.28,FALSE,155,160,315,2.7
373,White,21,Female,2.26,FALSE,144,153,297,2.63
284,Hispanic,30,Female,2.25,TRUE,144,138,282,3.57
356,Asian,22,Female,2.64,TRUE,130,136,266,3.39
0675,Black,30,Female,1.22,FALSE,150,147,297,2.48
0803,White,30,Trans*,3.97,FALSE,145,141,286,3.46
1134,White,27,Trans*,1.68,FALSE,156,161,317,2.56
0358,Asian,29,Trans*,2.77,FALSE,132,141,273,3.5
002,White,28,Female,2.52,TRUE,143,130,273,3.59
657,Black,29,Female,2.59,TRUE,138,138,276,3
312,Hispanic,20,Female,1.69,TRUE,157,133,290,3.31
1891,Black,30,Male,3.36,FALSE,143,140,283,3.29
0821,Hispanic,29,Male,1.52,FALSE,161,159,320,2.01
1820,White,22,Female,1.02,FALSE,164,131,295,2.79
0311,White,27,Male,2.17,FALSE,162,155,317,3.77
0095,Black,27,Female,2.88,FALSE,149,169,318,3.05
1081,Hispanic,20,Female,3.81,FALSE,134,156,290,2.75
1106,Black,23,Male,2.34,FALSE,170,149,319,1.56
0982,Hispanic,30,Male,3.75,FALSE,160,167,327,2.94
0102,White,26,Female,2.85,FALSE,164,163,327,2.97
513,Asian,30,Female,2.28,TRUE,148,139,287,3.23
1918,White,26,Trans*,2.24,FALSE,167,155,322,2.84
1006,White,30,Female,2.2,FALSE,137,159,296,3.46
467,White,21,Trans*,2.65,FALSE,150,142,292,3.16
612,Black,28,Trans*,2.54,TRUE,152,138,290,3.36
0996,White,27,Trans*,3.12,FALSE,138,136,274,3.72
533,White,26,Female,2.99,TRUE,147,137,284,2.7
0818,White,20,Trans*,2.1,FALSE,144,143,287,2.47
477,White,24,Male,3.59,TRUE,148,133,281,3.71
0452,Black,25,Trans*,3.84,FALSE,154,167,321,2.62
0569,White,29,Female,3.91,FALSE,148,148,296,3.55
1035,Hispanic,24,Male,3.5,FALSE,152,130,282,2.36
398,White,29,Male,2.59,TRUE,136,136,272,3.24
620,White,25,Trans*,2.42,TRUE,154,143,297,2.8
144,Hispanic,22,Male,2.94,FALSE,130,145,275,2.66
1034,Hispanic,26,Male,1.35,FALSE,143,134,277,3.3
1380,White,26,Female,1.77,FALSE,159,138,297,3.88
1777,White,20,Female,2.66,FALSE,139,155,294,1.44
0838,White,25,Trans*,3.24,FALSE,131,161,292,3.16
317,Hispanic,25,Trans*,2.36,FALSE,149,136,285,2.67
1561,White,29,Male,3.19,FALSE,147,146,293,3.18
1257,White,26,Trans*,2.2,FALSE,164,160,324,2.55
295,White,22,Trans*,2.77,TRUE,154,132,286,3.88
1232,White,25,Trans*,1.49,FALSE,132,163,295,3.46
0325,White,29,Female,3.04,FALSE,140,133,273,2.46
164,White,28,Trans*,1.62,TRUE,148,138,286,3.26
1031,Black,26,Male,3.32,FALSE,155,145,300,2.91
0489,Hispanic,21,Trans*,3.05,FALSE,144,153,297,3.85
1149,White,30,Female,2.98,FALSE,152,153,305,3.76
771,Black,30,Trans*,3,TRUE,157,130,287,2.28
1604,White,26,Female,1.46,FALSE,137,160,297,3.56
727,White,23,Female,3.11,TRUE,152,139,291,2.71
570,Bi-Racial,28,Female,2.15,FALSE,138,132,270,2.73
1525,White,26,Female,1.16,FALSE,134,149,283,3.5
0316,Black,27,Trans*,1.74,FALSE,149,165,314,3.9
1736,Hispanic,25,Trans*,1.4,FALSE,152,132,284,2.75
1652,White,23,Female,3.37,FALSE,143,158,301,2.77
0922,Hispanic,28,Female,3.58,FALSE,141,145,286,3.12
064,Hispanic,26,Male,3.41,FALSE,149,132,281,2.43
616,Black,24,Female,2.76,FALSE,142,138,280,3.26
0196,White,22,Trans*,3.67,FALSE,146,133,279,3
0864,White,25,Male,3.18,FALSE,153,159,312,3.32
1068,White,26,Trans*,2.37,FALSE,155,169,324,3.96
399,White,29,Female,2.47,TRUE,137,149,286,2.67
1323,White,26,Trans*,1.12,FALSE,130,153,283,2.67
1875,White,28,Male,1.48,FALSE,136,149,285,3.54
494,White,21,Male,3.18,TRUE,141,131,272,3.55
0083,White,21,Male,1.6,FALSE,133,161,294,3.93
519,Hispanic,25,Trans*,1.86,TRUE,159,139,298,2.94
1216,White,20,Female,3.2,FALSE,132,164,296,3.36
073,White,30,Male,2.99,TRUE,156,141,297,3.52
0539,White,24,Trans*,3.43,FALSE,139,154,293,2.29
061,Black,20,Trans*,2.98,TRUE,139,157,296,3.37
0630,White,25,Male,3.24,FALSE,150,149,299,3.58
0128,Hispanic,23,Trans*,1.87,FALSE,165,139,304,3.41
278,White,25,Trans*,2.92,TRUE,136,139,275,3.86
1123,Black,27,Female,2.27,FALSE,137,142,279,2.48
1067,White,27,Female,2.82,FALSE,134,131,265,2.99
1449,White,30,Trans*,3.37,FALSE,156,155,311,3.66
650,Black,26,Female,2.54,TRUE,153,131,284,3.72
0403,White,22,Trans*,3.72,FALSE,152,163,315,3.83
697,White,27,Trans*,2.21,TRUE,149,144,293,3.53
152,White,25,Female,2.49,FALSE,146,132,278,2.62
1282,White,22,Male,3.81,FALSE,145,140,285,3.09
0789,Hispanic,21,Trans*,2.91,FALSE,154,165,319,3.25
133,Hispanic,28,Male,2.33,FALSE,156,138,294,2.73
0394,White,21,Trans*,3.12,FALSE,158,148,306,1.64
1880,White,25,Male,2,FALSE,166,157,323,3.91
239,White,24,Trans*,1.83,TRUE,142,139,281,3.23
1189,Asian,29,Trans*,2.54,FALSE,141,145,286,2.93
0341,Black,25,Male,3.95,FALSE,147,148,295,3.92
1663,Black,25,Female,2.84,FALSE,138,156,294,3.05
1836,White,24,Female,3.64,FALSE,159,151,310,3.43
223,White,24,Trans*,2.32,FALSE,131,135,266,2.4
0688,White,29,Male,2.03,FALSE,143,146,289,3.79
0251,White,27,Trans*,1.41,FALSE,138,153,291,2.97
1954,Hispanic,30,Female,1.55,FALSE,134,143,277,2.81
1562,White,23,Trans*,2.4,FALSE,143,167,310,1.88
028,Black,21,Male,2.88,TRUE,140,130,270,2.53
0446,Black,27,Trans*,1.53,FALSE,162,130,292,3.21
1912,Hispanic,28,Trans*,1.57,FALSE,154,151,305,2.93
0832,White,26,Male,3.61,FALSE,139,147,286,3.54
0129,White,22,Female,2.3,FALSE,159,154,313,3.57
1851,White,20,Male,2.41,FALSE,150,162,312,2.8
710,White,23,Trans*,2.05,FALSE,150,131,281,3.36
206,White,27,Trans*,2.12,FALSE,158,130,288,3.28
0847,White,27,Female,3.49,FALSE,141,168,309,2.91
1317,White,21,Male,2.63,FALSE,146,132,278,2.83
022,White,30,Trans*,1.79,TRUE,147,131,278,3.01
0575,White,27,Trans*,3.61,FALSE,163,144,307,1.9
734,White,27,Male,2.47,TRUE,151,132,283,3.32
737,White,21,Trans*,2.28,FALSE,152,139,291,3.08
0549,White,26,Female,3.8,FALSE,142,152,294,3.44
0817,Black,26,Female,2.38,FALSE,159,137,296,3.46
674,White,27,Male,2.26,TRUE,136,131,267,3.78
601,White,23,Male,2.93,TRUE,154,137,291,2.99
640,White,22,Female,2.4,TRUE,149,131,280,3.23
1217,White,23,Male,2.48,FALSE,156,164,320,2.75
0701,White,22,Trans*,1.26,FALSE,153,158,311,3.55
127,Asian,21,Trans*,2.94,FALSE,151,136,287,3.65
754,Black,29,Female,3.16,TRUE,152,130,282,2.79
0245,White,29,Male,1,FALSE,130,166,296,2.82
0034,Black,22,Male,1.54,FALSE,142,152,294,3.62
768,White,27,Female,2.33,FALSE,154,133,287,3.07
1479,White,25,Male,1.48,FALSE,138,141,279,2.57
151,White,30,Male,3.06,TRUE,148,141,289,3.31
216,White,22,Female,2.38,FALSE,156,130,286,2.74
422,Hispanic,27,Trans*,2.96,FALSE,137,130,267,3.03
1620,Black,20,Trans*,2.7,FALSE,154,135,289,3.73
0037,White,25,Male,2.65,FALSE,136,133,269,3.96
0931,Black,21,Trans*,1.64,FALSE,152,151,303,3.73
223,White,27,Female,2.79,TRUE,158,132,290,3
0120,White,22,Trans*,2.37,FALSE,144,167,311,2.25
344,White,27,Trans*,2.38,FALSE,154,133,287,2.55
1971,White,24,Male,2.12,FALSE,143,135,278,3.29
1605,White,27,Female,3.77,FALSE,143,161,304,2.47
486,White,21,Trans*,3.2,FALSE,155,139,294,2.39
668,White,23,Male,2.73,FALSE,141,146,287,3.27
1086,White,21,Trans*,2.31,FALSE,143,162,305,3.52
1137,White,24,Female,2.7,FALSE,139,158,297,1.39
1236,White,29,Trans*,1.6,FALSE,139,147,286,3.31
436,Asian,29,Trans*,2.86,FALSE,138,140,278,2.5
1263,White,24,Male,2.89,FALSE,159,165,324,3.79
217,White,30,Male,2.53,FALSE,153,133,286,2.66
114,White,28,Male,1.71,TRUE,146,131,277,3.11
0920,White,29,Trans*,1.1,FALSE,131,157,288,2.84
1062,White,23,Female,3.91,FALSE,136,135,271,3.71
0014,White,29,Trans*,3.2,FALSE,157,147,304,2.82
1304,White,29,Trans*,1.23,FALSE,158,161,319,3.96
0765,White,24,Trans*,2,FALSE,145,146,291,2.45
1588,White,22,Male,1.66,FALSE,152,138,290,3.05
756,White,26,Trans*,2.82,FALSE,141,143,284,3.68
0703,White,28,Male,2.46,FALSE,138,151,289,3.7
124,White,23,Male,2.52,FALSE,141,132,273,3.03
309,White,28,Trans*,2.42,FALSE,157,134,291,2.66
396,White,21,Trans*,2.97,FALSE,145,145,290,2.57
451,White,24,Trans*,3.06,FALSE,142,136,278,2.01
787,Black,20,Male,3.06,FALSE,150,135,285,1.71
0662,Hispanic,21,Trans*,1.72,FALSE,139,161,300,3.61
1535,White,27,Trans*,2.59,FALSE,159,131,290,2.21
129,White,26,Female,2.52,TRUE,136,147,283,2.79
0086,Black,21,Male,2.88,FALSE,144,152,296,2.63
648,Black,20,Female,1.79,TRUE,153,135,288,3.45
1432,White,26,Female,2.09,FALSE,161,169,330,3
1892,White,22,Trans*,2.63,FALSE,144,142,286,2.44
1782,White,26,Female,2.83,FALSE,143,149,292,3.56
746,White,22,Trans*,1.53,TRUE,168,144,312,3.55
784,White,28,Male,1.83,FALSE,153,134,287,2.72
331,Hispanic,24,Female,3.33,TRUE,157,131,288,2.56
0168,White,28,Female,3.09,FALSE,148,161,309,3.14
0228,Hispanic,24,Female,3.13,FALSE,147,153,300,2.92
102,White,24,Male,2.21,TRUE,165,130,295,3.91
0031,White,28,Trans*,2.14,FALSE,151,162,313,3.11
1306,Hispanic,29,Female,3.85,FALSE,151,147,298,2.47
225,White,23,Female,2.84,TRUE,136,145,281,2.96
1003,White,27,Trans*,1.92,FALSE,166,160,326,3.63
1188,White,28,Female,3.11,FALSE,152,141,293,3.21
045,White,27,Trans*,2.63,TRUE,142,131,273,3.33
704,White,22,Male,2.37,FALSE,167,133,300,3.57
0516,Hispanic,29,Female,2.48,FALSE,143,137,280,2.83
0583,White,26,Female,3.86,FALSE,148,159,307,3.01
760,White,29,Trans*,2.31,FALSE,137,149,286,1.92
0310,Black,25,Trans*,1.46,FALSE,157,155,312,3.1
082,White,22,Male,2.37,FALSE,150,135,285,2.89
572,White,29,Male,2.62,FALSE,146,139,285,2.79
1592,White,20,Trans*,3.76,FALSE,146,167,313,2.68
105,Black,24,Female,3.28,FALSE,131,131,262,2.94
029,Asian,25,Trans*,2.01,FALSE,152,139,291,3.22
0759,White,26,Trans*,3.03,FALSE,158,145,303,2.66
465,White,30,Female,3.02,TRUE,147,137,284,3
575,White,25,Trans*,1.95,TRUE,147,132,279,3.49
0943,Black,23,Male,3.26,FALSE,153,141,294,3.15
369,White,20,Trans*,2.6,FALSE,152,132,284,2.2
076,White,27,Female,2.19,FALSE,154,154,308,2.51
476,White,21,Trans*,2.44,FALSE,139,134,273,2.61
1301,White,30,Trans*,2.99,FALSE,144,152,296,2.81
0088,Black,29,Male,2.84,FALSE,149,140,289,2.41
0220,White,28,Female,3.05,FALSE,156,151,307,2.52
1539,Asian,28,Female,2.54,FALSE,150,146,296,2.03
676,Black,21,Male,2.42,TRUE,155,135,290,2.82
053,Hispanic,27,Male,2,TRUE,158,132,290,2.91
1837,Black,28,Trans*,1.49,FALSE,151,153,304,2.25
0923,Black,23,Trans*,1.05,FALSE,131,161,292,3.85
463,White,25,Trans*,3.39,TRUE,165,137,302,3.84
0746,Black,26,Male,3.28,FALSE,146,141,287,3.28
301,White,21,Female,2.17,FALSE,132,135,267,2.61
0015,Asian,27,Male,3.96,FALSE,160,147,307,2.37
562,Native,28,Trans*,2.93,TRUE,139,135,274,2.98
309,White,30,Female,2.56,TRUE,141,141,282,2.93
122,Asian,30,Female,2.96,FALSE,134,144,278,3.45
738,White,24,Trans*,2.38,FALSE,164,137,301,3.4
083,White,22,Female,2.71,TRUE,150,149,299,3.93
185,Asian,20,Male,3.22,TRUE,133,130,263,3.17
260,Bi-Racial,27,Trans*,3.49,FALSE,157,134,291,2.25
1336,White,20,Male,2.69,FALSE,152,132,284,3.87
610,Hispanic,24,Female,3.06,FALSE,132,150,282,2.77
0521,White,29,Male,2.32,FALSE,153,165,318,3.83
0980,White,20,Male,1.75,FALSE,163,147,310,2.51
0710,Hispanic,22,Female,3.35,FALSE,148,141,289,3.15
0618,White,29,Male,1.06,FALSE,155,144,299,1.96
0932,White,24,Trans*,2.39,FALSE,154,148,302,3.09
412,White,24,Male,2.72,FALSE,143,136,279,2.29
732,White,29,Female,2.76,TRUE,136,133,269,3.24
185,White,25,Male,2.41,FALSE,143,138,281,3.61
0210,Black,21,Male,2.17,FALSE,141,165,306,3.39
1192,White,23,Male,3.27,FALSE,141,130,271,3.63
1581,Asian,21,Male,2.5,FALSE,152,161,313,3.72
1460,White,22,Male,2.72,FALSE,144,160,304,2.38
1122,Black,20,Trans*,2.7,FALSE,143,142,285,2.68
0523,Black,25,Trans*,3.18,FALSE,162,159,321,3.22
1806,White,23,Female,1.87,FALSE,146,162,308,3.51
1972,White,23,Male,1.27,FALSE,131,137,268,3.97
0124,White,23,Male,2.71,FALSE,160,136,296,3.79
1952,Hispanic,24,Female,1.97,FALSE,153,142,295,1.69
0904,White,24,Female,3.97,FALSE,155,152,307,3.95
511,White,28,Trans*,2.26,FALSE,131,148,279,3.14
1528,White,23,Trans*,1.83,FALSE,136,147,283,2.07
596,Hispanic,21,Male,3.72,TRUE,135,146,281,3.08
227,Black,30,Male,1.79,TRUE,143,148,291,3.61
116,Black,25,Trans*,2.8,FALSE,163,130,293,2.61
1124,White,28,Trans*,3.28,FALSE,135,153,288,3.93
412,Black,20,Trans*,2.72,TRUE,162,138,300,2.89
168,White,24,Male,2.01,TRUE,141,150,291,3.76
500,White,24,Female,2.63,TRUE,132,132,264,2.81
024,Hispanic,23,Female,2.04,FALSE,158,141,299,2.9
1418,Hispanic,20,Female,2.27,FALSE,140,152,292,3.11
1978,White,29,Female,2.64,FALSE,144,135,279,1.67
529,White,28,Male,1.96,TRUE,169,137,306,3.58
0769,Hispanic,27,Female,1.85,FALSE,145,131,276,3.41
370,Hispanic,20,Male,2.3,TRUE,146,139,285,3.41
1440,White,25,Male,3.84,FALSE,147,136,283,2.27
726,White,27,Male,2.47,FALSE,152,131,283,3.54
0206,Black,24,Trans*,3,FALSE,149,138,287,3.97
295,Hispanic,23,Female,1.61,FALSE,164,145,309,3.3
0017,White,25,Trans*,2.63,FALSE,133,154,287,3.83
008,White,21,Trans*,1.82,TRUE,139,142,281,3.1
0785,White,30,Trans*,2.4,FALSE,140,168,308,3.9
285,Hispanic,24,Male,2.67,TRUE,158,148,306,2.81
615,Asian,24,Trans*,1.25,TRUE,156,130,286,3.17
585,White,30,Male,2.03,TRUE,132,133,265,3.09
1113,White,22,Trans*,1.62,FALSE,150,168,318,3.25
509,White,25,Male,1.67,TRUE,147,137,284,3.47
163,White,25,Male,2.02,TRUE,152,131,283,3.26
1435,White,30,Male,2.49,FALSE,155,154,309,3.65
1803,White,22,Female,1.88,FALSE,143,166,309,3.79
1041,White,22,Trans*,2.94,FALSE,143,149,292,3.65
1219,Hispanic,23,Male,1.36,FALSE,133,160,293,3.43
643,Hispanic,24,Male,1.94,FALSE,146,132,278,2.98
1231,White,23,Female,2.38,FALSE,131,166,297,3.03
1058,White,27,Female,3.71,FALSE,143,147,290,3.72
560,Black,23,Female,2.27,TRUE,149,131,280,2.68
1688,Hispanic,29,Female,2.69,FALSE,147,140,287,1.49
0798,White,25,Female,1.14,FALSE,137,138,275,3.77
283,White,25,Female,3.02,FALSE,154,135,289,2.35
1375,White,28,Female,3.3,FALSE,151,153,304,1.72
402,Native,23,Female,2.29,FALSE,140,134,274,3.44
0629,Black,22,Male,2.96,FALSE,136,155,291,2.99
1832,White,25,Trans*,1.29,FALSE,168,162,330,2.59
491,Hispanic,21,Female,2.35,FALSE,149,144,293,2.87
378,White,26,Female,3.02,FALSE,141,142,283,3.19
270,Hispanic,27,Female,2.99,TRUE,145,135,280,2.99
358,Hispanic,26,Male,3.4,TRUE,135,138,273,4
064,White,24,Male,3.08,TRUE,151,140,291,2.82
0977,Black,30,Male,3.32,FALSE,141,140,281,2.91
276,White,30,Female,2.61,FALSE,133,131,264,3.91
0396,White,29,Trans*,3.1,FALSE,142,160,302,3.84
535,White,26,Male,2.21,TRUE,152,142,294,2.63
0239,White,30,Female,3.07,FALSE,148,162,310,3.88
423,White,21,Male,2.76,FALSE,142,142,284,3.13
0901,White,29,Male,2.68,FALSE,138,136,274,3.63
0486,Native,21,Trans*,2,FALSE,152,138,290,2.4
219,White,25,Male,2.54,FALSE,135,137,272,2.76
1694,Black,24,Trans*,3.46,FALSE,168,159,327,1.7
170,White,25,Trans*,2.42,TRUE,150,139,289,3.5
1101,Black,21,Male,3.49,FALSE,156,151,307,3.55
270,Black,28,Male,2.33,FALSE,134,133,267,2.6
1569,White,24,Female,2.65,FALSE,139,160,299,3.52
0775,White,23,Male,3.11,FALSE,152,144,296,2.45
0293,White,20,Trans*,2.39,FALSE,161,137,298,2.83
0913,White,28,Male,2.05,FALSE,136,166,302,3.43
0566,White,26,Trans*,3.93,FALSE,151,155,306,3.89
1060,White,28,Male,1.99,FALSE,132,168,300,3.94
1248,Black,21,Female,1.61,FALSE,131,157,288,3.57
1399,White,20,Female,1.55,FALSE,154,145,299,3.45
757,White,24,Female,1.97,FALSE,158,130,288,3.18
0422,White,24,Female,1.74,FALSE,157,141,298,3.95
1033,White,30,Trans*,1.85,FALSE,141,141,282,2.3
460,White,30,Female,2.9,FALSE,152,141,293,2.8
512,Hispanic,21,Female,1.93,FALSE,158,134,292,3.39
0376,White,23,Trans*,2.55,FALSE,158,150,308,3.77
218,White,22,Trans*,2.15,FALSE,159,135,294,2.58
153,Bi-Racial,27,Female,2.31,FALSE,154,133,287,2.71
716,White,27,Male,2.83,FALSE,143,139,282,3.55
1178,White,25,Trans*,2.73,FALSE,140,147,287,2.8
043,White,28,Female,2.92,FALSE,138,136,274,2.82
1341,Hispanic,26,Male,3.72,FALSE,144,145,289,3.01
392,White,23,Trans*,2.8,FALSE,157,150,307,3.74
732,White,23,Male,2.31,FALSE,158,134,292,3.04
1529,White,26,Female,2.27,FALSE,153,133,286,3.36
0223,White,28,Trans*,3.81,FALSE,160,141,301,2.66
0719,White,27,Female,1.89,FALSE,164,164,328,3.43
0262,Hispanic,27,Female,1.21,FALSE,144,165,309,2.85
0367,White,23,Female,2.82,FALSE,164,166,330,3.08
1676,White,28,Trans*,1.64,FALSE,152,161,313,1.95
319,White,21,Trans*,1.93,FALSE,148,132,280,3.31
1769,White,21,Trans*,3.59,FALSE,134,144,278,3.14
1487,White,25,Trans*,2.17,FALSE,145,132,277,3.69
436,Hispanic,23,Female,2.98,TRUE,157,131,288,2.72
264,White,21,Trans*,2.59,TRUE,149,135,284,4
1671,White,22,Female,2.41,FALSE,163,136,299,3.97
785,White,29,Male,2.66,FALSE,148,143,291,2.99
165,Black,28,Trans*,2.49,FALSE,144,132,276,3.24
1307,White,21,Male,2.16,FALSE,134,143,277,1.59
464,White,26,Female,2.38,FALSE,135,144,279,1.68
413,Bi-Racial,30,Female,3.71,FALSE,138,131,269,2.43
1265,Asian,28,Male,3.17,FALSE,159,154,313,2.51
0172,White,21,Trans*,3.79,FALSE,130,144,274,2.88
0077,White,25,Male,1.84,FALSE,134,164,298,3.99
0786,White,23,Female,2.26,FALSE,140,144,284,3
1845,Bi-Racial,26,Female,3.13,FALSE,133,144,277,3.87
243,White,25,Female,2.6,FALSE,165,132,297,2.98
0925,Black,29,Male,2.85,FALSE,132,149,281,2.1
554,White,27,Male,2.28,FALSE,131,131,262,2.84
318,White,23,Female,2.8,TRUE,132,167,299,3.31
0261,White,25,Trans*,2,FALSE,154,168,322,3.86
0670,White,30,Female,1.16,FALSE,145,151,296,1.58
0005,White,22,Trans*,1.02,FALSE,154,161,315,2.44
0687,Black,29,Male,3.77,FALSE,141,159,300,1.82
1849,Black,28,Male,1.49,FALSE,147,144,291,2.54
696,White,27,Trans*,2.77,TRUE,141,148,289,3.42
0006,Hispanic,28,Male,2.53,FALSE,156,140,296,3.05
564,Black,25,Male,2.09,TRUE,150,134,284,2.88
695,White,25,Male,2.64,TRUE,131,138,269,3.97
253,White,23,Trans*,3.38,TRUE,157,146,303,3.2
1860,White,23,Male,2.56,FALSE,141,153,294,3.65
011,White,30,Female,3.03,FALSE,156,131,287,3.54
526,Black,28,Male,2.24,TRUE,142,135,277,3.63
0475,White,26,Female,3.47,FALSE,150,149,299,3.76
304,White,23,Female,2.62,FALSE,161,135,296,2.98
765,White,30,Female,2.61,FALSE,142,132,274,2.77
1586,White,25,Trans*,1.75,FALSE,142,169,311,2.93
0042,Asian,28,Male,3.98,FALSE,137,154,291,3.54
1261,White,25,Male,2.24,FALSE,167,161,328,3.66
720,White,23,Trans*,2.74,FALSE,130,130,260,2.24
0948,White,24,Male,1.96,FALSE,154,153,307,2.86
0894,White,24,Female,2.77,FALSE,151,164,315,2.26
014,White,22,Female,2.23,FALSE,148,133,281,2.54
0884,White,30,Male,2.46,FALSE,145,159,304,3.76
391,White,26,Female,1.87,FALSE,136,131,267,3.05
0292,White,30,Female,2.75,FALSE,149,149,298,2.9
1986,White,25,Trans*,3.98,FALSE,139,164,303,3.25
745,Black,30,Trans*,2.63,FALSE,152,144,296,2.41
456,White,26,Male,2.52,FALSE,137,156,293,3.41
0508,White,27,Male,2.25,FALSE,142,151,293,3.32
1180,White,29,Trans*,2.75,FALSE,148,160,308,3.05
0880,White,24,Male,1.43,FALSE,143,148,291,2.88
632,White,22,Trans*,2.54,FALSE,136,141,277,2.65
169,Black,27,Trans*,2.51,TRUE,134,151,285,3.82
1791,Hispanic,29,Male,3.15,FALSE,138,164,302,3.37
560,Hispanic,29,Female,2.08,FALSE,141,134,275,3.16
374,Black,23,Trans*,1.73,FALSE,148,132,280,2.27
299,White,29,Female,2.37,TRUE,155,133,288,3.68
0726,White,26,Female,1.9,FALSE,130,149,279,3.71
0052,Black,23,Female,2.84,FALSE,137,155,292,2.37
0722,Hispanic,21,Male,1.08,FALSE,156,150,306,3.68
0981,White,29,Trans*,1.73,FALSE,135,168,303,2.27
645,White,28,Male,3.24,TRUE,157,141,298,3.95
634,White,26,Male,3.34,TRUE,135,136,271,2.86
1057,Hispanic,20,Female,3.37,FALSE,141,135,276,3.92
770,White,23,Male,2.71,TRUE,147,131,278,3.42
618,Hispanic,20,Female,2.55,TRUE,150,136,286,2.91
1247,Bi-Racial,27,Male,1.44,FALSE,134,149,283,2.85
189,White,22,Male,3.59,FALSE,133,147,280,2.92
165,White,23,Trans*,2.32,TRUE,146,140,286,3.01
717,White,21,Female,1.92,FALSE,159,131,290,3.26
0944,Black,28,Female,1.33,FALSE,139,151,290,2.65
193,White,28,Female,1.89,TRUE,148,130,278,3.12
711,Hispanic,25,Female,3.14,TRUE,159,135,294,3.33
322,Black,26,Male,2.5,TRUE,136,143,279,2.78
1464,White,26,Female,1.81,FALSE,159,144,303,2.57
0359,Black,22,Trans*,1.85,FALSE,156,166,322,2.14
179,White,24,Male,2.78,TRUE,137,137,274,3.9
727,White,22,Trans*,2.28,FALSE,161,134,295,2.88
271,White,23,Trans*,2.8,FALSE,167,143,310,2.71
1812,White,27,Trans*,2.3,FALSE,131,167,298,3.54
0728,Black,22,Trans*,1.98,FALSE,131,138,269,3.34
0323,Native,22,Female,2.26,FALSE,167,168,335,3.24
1370,White,21,Male,2.08,FALSE,154,161,315,3.26
1335,White,21,Trans*,3.01,FALSE,153,155,308,3.3
324,White,28,Male,3.22,FALSE,134,132,266,3.16
267,Hispanic,30,Female,2.34,TRUE,131,133,264,3.29
0269,Asian,28,Trans*,3.48,FALSE,134,168,302,1.37
1239,White,21,Male,2.39,FALSE,139,153,292,3.47
323,Black,29,Trans*,1.91,FALSE,155,136,291,3.69
1873,White,21,Female,2.37,FALSE,141,147,288,3.77
510,Hispanic,23,Female,1.98,TRUE,146,135,281,3.55
0678,White,26,Female,3.37,FALSE,142,134,276,3.42
385,White,21,Male,2.81,TRUE,163,131,294,3.41
016,White,25,Female,2.33,FALSE,143,132,275,2.09
1785,Black,22,Male,2.86,FALSE,134,164,298,3.62
1279,White,25,Male,3.58,FALSE,135,157,292,3.39
567,Hispanic,26,Male,2.95,TRUE,152,131,283,3.82
027,White,25,Female,2.39,TRUE,141,136,277,3.45
383,White,29,Female,2.92,TRUE,152,140,292,3.96
767,Asian,23,Trans*,3.97,TRUE,136,136,272,3.27
0317,Hispanic,24,Trans*,3.53,FALSE,138,136,274,2.49
459,Hispanic,30,Female,2.97,FALSE,144,140,284,2.75
790,White,24,Female,2.13,TRUE,156,158,314,2.91
701,White,29,Trans*,2.59,TRUE,157,132,289,3.22
0795,White,29,Trans*,1.29,FALSE,143,135,278,3.51
292,White,22,Male,2.01,FALSE,148,135,283,2.91
1882,Black,23,Female,2.22,FALSE,150,142,292,3.73
1571,White,28,Female,3.79,FALSE,158,155,313,3.08
118,White,21,Trans*,1.7,FALSE,144,131,275,2.44
0572,Hispanic,30,Trans*,2.65,FALSE,140,144,284,2.09
502,Hispanic,24,Trans*,2.62,TRUE,141,137,278,3.51
548,Hispanic,29,Female,2.51,FALSE,160,136,296,2.34
583,Hispanic,30,Trans*,2.42,FALSE,149,146,295,3.95
447,Black,22,Female,2.44,TRUE,145,133,278,2.63
1566,White,28,Male,2.63,FALSE,148,163,311,3.59
673,White,29,Female,2.67,TRUE,136,139,275,3.59
1260,Hispanic,30,Male,3.04,FALSE,131,149,280,3.55
1965,Hispanic,21,Female,3.34,FALSE,147,149,296,3.51
679,Hispanic,27,Male,2.09,FALSE,140,135,275,3.01
520,White,25,Male,3.01,TRUE,166,131,297,2.7
661,White,27,Male,3.03,TRUE,167,136,303,3.68
113,White,22,Male,2.55,FALSE,162,136,298,2.67
694,White,21,Female,3.57,TRUE,157,134,291,2.21
1612,Black,30,Trans*,1.52,FALSE,142,149,291,2.97
