ID,Race,Age,Gender,undergrad_gpa,math_camp,gre_verbal,gre_quant,gre_total,graduate_gpa
266,White,22,Female,2.96,FALSE,140,132,272,3.88
239,White,24,Trans*,1.83,TRUE,142,139,281,3.23
585,White,30,Male,2.03,TRUE,132,133,265,3.09
727,White,22,Trans*,2.28,FALSE,161,134,295,2.88
320,Black,24,Trans*,3.01,TRUE,138,131,269,2.9
274,Hispanic,30,Female,2.92,FALSE,131,134,265,2.66
438,White,28,Female,3.02,FALSE,142,131,273,3.62
355,Hispanic,25,Trans*,2.62,FALSE,134,131,265,2.88
239,White,21,Trans*,2.06,FALSE,144,137,281,1.32
367,Hispanic,29,Female,1.71,FALSE,147,139,286,2.27
201,Black,25,Female,1.75,FALSE,162,142,304,2.02
557,White,25,Female,2.52,TRUE,130,131,261,3.47
284,Hispanic,30,Female,2.25,TRUE,144,138,282,3.57
139,White,21,Male,2,TRUE,161,142,303,2.61
235,Asian,22,Male,3.38,FALSE,137,134,271,2.47
687,Black,20,Male,2.79,TRUE,151,130,281,3.56
536,Native,20,Trans*,3.63,TRUE,138,164,302,3.5
443,White,21,Male,2.04,FALSE,168,151,319,3.05
438,Asian,28,Trans*,1.87,TRUE,168,131,299,2.75
746,White,22,Trans*,1.53,TRUE,168,144,312,3.55
777,White,24,Trans*,2.84,TRUE,136,134,270,3.51
173,Hispanic,26,Female,2.98,TRUE,152,131,283,3.37
300,White,27,Female,2.81,TRUE,140,133,273,2.69
630,White,27,Female,2.42,FALSE,144,132,276,3.45
112,White,20,Male,2.53,TRUE,143,130,273,3.78
728,White,30,Male,2.13,TRUE,161,151,312,3.5
119,White,28,Trans*,3.12,TRUE,155,137,292,3.53
506,White,21,Trans*,2.81,FALSE,154,135,289,3.23
750,Hispanic,23,Male,2.26,TRUE,157,134,291,3.13
354,Hispanic,25,Female,3.42,TRUE,148,152,300,3.35
432,Hispanic,23,Female,3.29,TRUE,152,137,289,2.6
692,White,28,Male,2.43,TRUE,163,151,314,3.87
072,Black,24,Female,2.18,TRUE,157,132,289,3.51
484,White,23,Female,2.11,FALSE,130,130,260,2.62
489,Hispanic,22,Female,2.48,TRUE,151,141,292,2.64
479,White,25,Female,2.22,FALSE,132,134,266,3.17
215,White,26,Female,3.15,TRUE,151,136,287,2.94
493,Black,28,Male,2.92,TRUE,147,142,289,3.62
376,Black,28,Trans*,2.65,FALSE,169,137,306,2.57
559,Asian,29,Male,3.61,FALSE,146,134,280,3.49
486,White,21,Female,2.16,TRUE,159,131,290,2.56
564,Black,25,Male,2.09,TRUE,150,134,284,2.88
509,Black,20,Male,2.23,FALSE,157,132,289,3.68
599,White,23,Female,3.06,TRUE,146,140,286,3.21
221,White,27,Female,2.62,TRUE,144,134,278,3.41
473,Asian,20,Male,2.28,FALSE,143,133,276,3.19
607,Asian,25,Trans*,1.73,FALSE,169,145,314,2.82
660,Asian,21,Male,3.17,TRUE,140,143,283,2.59
087,White,26,Female,2.7,TRUE,145,132,277,3.23
246,Hispanic,20,Female,2.92,FALSE,144,134,278,2.74
158,Black,30,Female,2.78,FALSE,154,134,288,2.74
494,White,21,Male,3.18,TRUE,141,131,272,3.55
594,Hispanic,25,Trans*,2.52,FALSE,155,145,300,2.09
776,White,25,Male,2.29,TRUE,155,133,288,3.91
295,Hispanic,23,Female,1.61,FALSE,164,145,309,3.3
681,Asian,29,Female,2.54,FALSE,140,131,271,3.13
540,White,28,Male,2.14,TRUE,153,133,286,3.52
558,Hispanic,22,Trans*,2.23,FALSE,158,142,300,2.98
742,Black,29,Trans*,2.95,FALSE,155,131,286,2.9
771,White,26,Male,2.96,FALSE,133,136,269,3.61
470,White,30,Male,2.76,FALSE,158,131,289,2.47
747,White,23,Female,2.57,FALSE,140,137,277,2.2
417,Hispanic,24,Male,1.69,FALSE,136,144,280,3.48
287,Black,27,Trans*,2.35,FALSE,132,145,277,2.41
672,Asian,25,Male,1.85,TRUE,150,139,289,3.04
744,White,29,Male,3.46,TRUE,130,133,263,2.72
094,White,24,Trans*,3.23,FALSE,146,138,284,2.65
549,White,28,Male,2.53,FALSE,146,135,281,3.02
085,White,29,Male,1.94,TRUE,150,141,291,3.64
720,White,26,Trans*,2.56,TRUE,132,131,263,3.22
273,White,22,Male,2.03,FALSE,144,132,276,2.86
515,White,30,Male,2.09,TRUE,150,131,281,3.62
640,White,22,Female,2.4,TRUE,149,131,280,3.23
521,Black,27,Trans*,2.73,TRUE,151,134,285,3.44
390,Asian,21,Female,2.4,TRUE,142,136,278,3.41
269,White,24,Trans*,2.79,TRUE,133,132,265,3.9
483,Black,25,Female,1.97,FALSE,147,138,285,2.72
049,White,20,Female,1.99,FALSE,135,152,287,3.5
283,Black,24,Male,3.01,TRUE,159,132,291,3.39
195,Black,23,Female,2.36,TRUE,136,136,272,2.58
737,White,21,Trans*,2.28,FALSE,152,139,291,3.08
296,Black,20,Male,2.24,FALSE,142,141,283,2.14
168,Bi-Racial,30,Trans*,3.2,FALSE,156,136,292,2.86
015,White,25,Trans*,2.24,TRUE,137,141,278,2.69
622,White,24,Female,2.56,FALSE,133,144,277,2.93
067,Hispanic,20,Male,2.65,FALSE,155,132,287,3.42
517,White,29,Female,2.65,TRUE,132,146,278,3.19
409,White,21,Female,2.38,TRUE,157,130,287,3.23
752,Hispanic,21,Trans*,3.14,TRUE,152,157,309,3.7
178,White,27,Female,2.4,TRUE,142,141,283,3.17
673,White,29,Female,2.67,TRUE,136,139,275,3.59
365,Black,27,Trans*,2.26,TRUE,146,146,292,3.51
332,Black,24,Trans*,1.67,TRUE,159,140,299,3.82
693,White,23,Male,2.07,FALSE,139,131,270,3.59
756,White,26,Trans*,2.82,FALSE,141,143,284,3.68
230,White,21,Male,2.1,TRUE,143,131,274,3.78
591,Asian,20,Trans*,2.52,TRUE,167,133,300,3.68
494,White,30,Trans*,2.84,FALSE,143,137,280,2.54
133,White,29,Male,1.66,TRUE,142,131,273,3.32
330,Black,24,Female,2.31,TRUE,147,132,279,3.59
779,White,30,Male,2.11,TRUE,160,135,295,3.63
411,White,23,Trans*,2.07,FALSE,161,134,295,3.13
226,White,24,Male,3.24,TRUE,146,132,278,3.43
637,Hispanic,25,Trans*,3.21,FALSE,155,135,290,2.91
442,Black,24,Female,2.86,TRUE,152,133,285,3.78
425,Asian,26,Female,2.35,TRUE,163,143,306,3.91
381,White,21,Trans*,2.55,TRUE,143,142,285,2.64
030,White,25,Trans*,1.82,FALSE,155,148,303,2.89
120,Hispanic,30,Trans*,1.88,TRUE,160,134,294,3.16
096,White,21,Female,2.99,FALSE,145,146,291,3.11
729,White,21,Trans*,2.97,TRUE,166,145,311,3.01
577,Black,30,Male,2.57,FALSE,135,143,278,3.4
254,White,20,Female,2.39,TRUE,139,140,279,3.08
251,White,26,Male,2.02,TRUE,143,136,279,3.99
124,Asian,26,Female,3.04,TRUE,165,130,295,3.1
739,Black,28,Trans*,1.52,FALSE,144,133,277,3.41
668,White,23,Male,2.73,FALSE,141,146,287,3.27
633,White,28,Trans*,3.12,TRUE,149,133,282,3.26
745,White,23,Trans*,2.74,TRUE,148,132,280,3.2
460,White,28,Female,2.4,TRUE,133,131,264,3.98
626,Asian,28,Female,3.25,TRUE,157,139,296,3.39
040,Black,26,Trans*,3.23,TRUE,167,142,309,3.45
427,White,23,Male,1.97,TRUE,139,136,275,2.91
045,Hispanic,24,Male,2.25,FALSE,135,136,271,2.7
127,White,22,Female,2.43,TRUE,169,155,324,3.53
559,White,28,Male,3.08,TRUE,162,148,310,3.24
043,White,28,Female,2.92,FALSE,138,136,274,2.82
081,Asian,28,Trans*,2.29,TRUE,136,130,266,3.91
133,Hispanic,28,Male,2.33,FALSE,156,138,294,2.73
722,Hispanic,24,Male,2.2,FALSE,140,138,278,3.51
098,White,28,Female,3.15,FALSE,155,131,286,3.62
452,Hispanic,23,Female,2.45,TRUE,137,131,268,3.41
240,Native,22,Male,2.47,TRUE,143,137,280,2.92
676,Black,21,Male,2.42,TRUE,155,135,290,2.82
075,White,26,Female,3.28,TRUE,134,136,270,3.55
037,Asian,22,Male,1.98,FALSE,153,145,298,3.19
361,White,22,Male,2.46,TRUE,152,145,297,3.76
743,White,30,Trans*,1.59,TRUE,140,141,281,3.69
779,Bi-Racial,22,Trans*,2.15,FALSE,154,158,312,3.29
674,Black,29,Female,2.62,FALSE,155,143,298,3.45
710,White,20,Male,1.39,TRUE,135,131,266,2.73
745,Black,30,Trans*,2.63,FALSE,152,144,296,2.41
257,White,21,Trans*,2.47,TRUE,158,130,288,3.15
756,Black,30,Female,2.25,TRUE,154,133,287,3.96
337,White,20,Female,2.88,FALSE,152,134,286,2.82
085,White,28,Female,2.07,FALSE,161,131,292,2.67
382,White,21,Female,2.6,TRUE,153,145,298,3.73
147,Hispanic,26,Female,2.59,TRUE,156,141,297,3.19
111,Asian,26,Female,2.26,FALSE,138,132,270,2.94
715,White,26,Female,3.51,TRUE,153,135,288,3.59
153,White,25,Male,3.51,TRUE,150,133,283,3.3
102,White,24,Male,2.21,TRUE,165,130,295,3.91
130,White,23,Female,2.71,TRUE,158,139,297,3.48
319,White,25,Female,2.17,TRUE,137,133,270,3.17
323,White,26,Trans*,2.14,TRUE,153,156,309,3.53
242,White,26,Trans*,1.41,TRUE,149,130,279,3.29
689,White,22,Male,2.52,FALSE,151,131,282,2.35
397,Hispanic,26,Female,3.01,FALSE,144,131,275,2.6
041,White,22,Female,3.19,FALSE,154,136,290,2.93
689,White,23,Female,2.39,TRUE,154,133,287,3.79
456,Hispanic,27,Trans*,2.01,TRUE,169,136,305,3.32
047,Hispanic,22,Male,2.19,TRUE,150,132,282,3.27
430,White,22,Trans*,1.82,TRUE,146,131,277,2.55
620,White,25,Trans*,2.42,TRUE,154,143,297,2.8
659,White,28,Trans*,1.74,TRUE,134,131,265,3.57
741,White,22,Female,2.71,FALSE,144,136,280,2.92
090,Black,22,Male,2.03,TRUE,152,136,288,2.94
612,Hispanic,23,Female,2.39,FALSE,142,133,275,3.03
308,White,26,Trans*,2.17,FALSE,165,137,302,3.77
126,Hispanic,21,Male,2.5,FALSE,131,131,262,3.28
171,White,22,Female,2.3,FALSE,139,143,282,2.69
032,White,29,Trans*,3.09,FALSE,152,137,289,2.8
706,White,28,Male,2.14,TRUE,168,155,323,3.08
338,White,22,Male,2.82,TRUE,138,156,294,3.45
098,White,29,Male,2.86,TRUE,153,143,296,3.81
221,White,20,Trans*,2.14,FALSE,166,141,307,3.2
627,White,27,Trans*,1.7,TRUE,160,137,297,3.74
481,White,28,Female,2.1,TRUE,134,139,273,3.43
080,White,29,Female,3.05,FALSE,155,138,293,3.81
666,White,23,Male,2.01,TRUE,158,145,303,2.95
633,White,24,Female,2.62,FALSE,150,133,283,2.83
057,White,28,Male,1.5,TRUE,159,130,289,3.5
587,White,24,Female,2.29,TRUE,161,135,296,3.9
790,White,24,Female,2.13,TRUE,156,158,314,2.91
683,White,23,Trans*,2.4,TRUE,149,133,282,3.82
632,White,20,Female,1.5,TRUE,166,131,297,3.34
030,White,20,Male,2.8,TRUE,132,132,264,2.15
089,Hispanic,23,Female,2.87,FALSE,154,134,288,2.62
027,White,25,Female,2.39,TRUE,141,136,277,3.45
401,Hispanic,21,Trans*,2.29,TRUE,140,136,276,2.83
666,White,23,Female,2.91,FALSE,155,132,287,2.3
223,White,27,Female,2.79,TRUE,158,132,290,3
379,White,24,Male,2.33,TRUE,145,138,283,3.87
114,White,28,Male,1.71,TRUE,146,131,277,3.11
065,White,20,Male,3.11,TRUE,147,138,285,3.85
526,White,28,Male,1.81,FALSE,152,132,284,3.87
465,White,30,Female,3.02,TRUE,147,137,284,3
674,White,27,Male,2.26,TRUE,136,131,267,3.78
356,Asian,22,Female,2.64,TRUE,130,136,266,3.39
172,White,20,Male,2.91,FALSE,132,130,262,3.37
250,Hispanic,30,Trans*,2.09,TRUE,133,131,264,3.13
372,White,27,Trans*,2.44,TRUE,163,132,295,3.27
257,Asian,22,Male,2.62,FALSE,146,133,279,3.03
581,Black,24,Male,1.9,TRUE,132,136,268,3.98
503,Black,23,Male,1.81,TRUE,144,136,280,3.5
582,White,28,Female,2.41,FALSE,162,132,294,1.84
193,White,28,Female,1.89,TRUE,148,130,278,3.12
568,White,24,Female,2.46,FALSE,150,141,291,3.69
374,White,20,Female,2.16,TRUE,150,136,286,2.92
343,Hispanic,22,Trans*,2.63,FALSE,143,134,277,3.32
393,Hispanic,27,Trans*,2.16,TRUE,162,137,299,2.44
649,White,22,Female,1.73,TRUE,166,144,310,3.29
284,White,23,Female,1.86,FALSE,146,135,281,2.49
032,White,29,Female,2.28,TRUE,137,134,271,3.92
244,White,28,Male,2.16,FALSE,135,134,269,2.79
383,White,29,Female,2.92,TRUE,152,140,292,3.96
194,Black,30,Trans*,2.66,TRUE,158,130,288,2.96
068,White,28,Female,1.95,TRUE,151,135,286,2.53
714,White,28,Male,3.06,FALSE,138,133,271,2.58
312,White,23,Male,2.62,FALSE,134,135,269,3.26
110,White,20,Trans*,3.06,FALSE,134,134,268,3.17
324,White,29,Male,2.64,TRUE,158,144,302,3.2
634,White,26,Male,3.34,TRUE,135,136,271,2.86
224,White,22,Male,2.51,FALSE,157,136,293,2.32
336,White,28,Male,2.27,FALSE,142,131,273,3.13
457,White,25,Female,2.81,TRUE,165,155,320,3.4
622,White,30,Trans*,2.39,TRUE,153,134,287,3.42
548,Black,27,Male,2.81,TRUE,133,142,275,3.78
270,Black,28,Male,2.33,FALSE,134,133,267,2.6
451,White,24,Trans*,3.06,FALSE,142,136,278,2.01
767,White,24,Female,2.62,FALSE,140,131,271,3
764,White,26,Female,2.69,TRUE,154,137,291,3.25
528,White,30,Female,3.9,TRUE,164,153,317,3.48
611,White,24,Female,2.22,FALSE,148,137,285,2.85
283,White,25,Female,3.02,FALSE,154,135,289,2.35
712,Bi-Racial,21,Trans*,2.23,TRUE,161,137,298,2.58
117,Asian,27,Trans*,2.33,FALSE,141,132,273,2.72
446,White,22,Trans*,2.02,FALSE,168,132,300,3.77
708,White,23,Male,2.77,FALSE,142,142,284,3.26
135,White,22,Male,3.2,FALSE,138,133,271,3.54
513,Black,26,Male,3.23,FALSE,142,132,274,3.25
347,Black,25,Female,3.28,FALSE,161,134,295,2.94
474,Asian,21,Male,3.21,TRUE,139,140,279,3.05
148,White,30,Female,2.71,TRUE,138,135,273,3.88
249,Asian,20,Female,3.01,TRUE,145,132,277,3.33
074,Hispanic,21,Female,2.6,FALSE,140,138,278,3.08
508,Hispanic,22,Female,2.12,FALSE,164,153,317,3.14
223,White,24,Trans*,2.32,FALSE,131,135,266,2.4
602,White,30,Male,2.97,TRUE,131,132,263,3.41
245,White,25,Male,2.97,FALSE,154,134,288,3.15
562,White,25,Female,1.96,FALSE,165,132,297,3.11
315,White,27,Female,3.02,FALSE,142,135,277,2.85
356,White,28,Female,2.26,FALSE,131,146,277,2.71
569,White,29,Female,3.35,TRUE,138,131,269,2.76
531,White,27,Trans*,1.78,TRUE,155,136,291,2.87
707,Hispanic,21,Female,2.64,FALSE,168,136,304,2.63
195,White,22,Male,2.06,FALSE,158,131,289,2.16
076,White,27,Female,2.19,FALSE,154,154,308,2.51
132,White,24,Female,2.84,TRUE,140,134,274,2.81
429,White,30,Trans*,2.54,TRUE,155,136,291,3.04
476,White,21,Trans*,2.44,FALSE,139,134,273,2.61
738,Black,22,Trans*,1.79,TRUE,152,139,291,2.7
413,Asian,25,Trans*,1.98,TRUE,167,135,302,3.74
645,White,28,Trans*,1.98,FALSE,158,163,321,2.92
276,White,30,Female,2.61,FALSE,133,131,264,3.91
373,White,21,Female,2.26,FALSE,144,153,297,2.63
573,Hispanic,26,Trans*,2.86,FALSE,140,132,272,3.13
043,White,26,Male,2.47,TRUE,143,133,276,3.73
400,Asian,30,Trans*,1.59,FALSE,140,135,275,2.3
402,White,23,Female,3.7,TRUE,164,137,301,3.07
710,White,23,Trans*,2.05,FALSE,150,131,281,3.36
743,Black,25,Female,2.9,FALSE,155,135,290,1.57
369,White,20,Trans*,2.6,FALSE,152,132,284,2.2
574,Hispanic,30,Trans*,1.9,TRUE,134,131,265,3.55
264,White,21,Trans*,2.59,TRUE,149,135,284,4
541,White,21,Female,3.24,TRUE,159,141,300,3.36
404,Hispanic,26,Male,2.51,TRUE,152,135,287,3.9
516,White,24,Trans*,1.2,FALSE,141,142,283,3.01
115,White,28,Trans*,1.82,TRUE,138,131,269,3.71
704,White,28,Female,2.77,TRUE,154,153,307,3.3
435,Asian,28,Trans*,1.65,FALSE,135,151,286,2.68
442,Hispanic,24,Male,2.79,FALSE,139,133,272,2.78
644,Asian,20,Trans*,2.35,TRUE,149,143,292,3
425,White,25,Trans*,2.35,FALSE,134,137,271,2.08
354,White,27,Female,2.75,FALSE,133,131,264,2.55
353,White,27,Female,2.44,TRUE,153,132,285,3.05
387,Hispanic,20,Trans*,3.24,TRUE,148,131,279,3.18
143,White,26,Trans*,2.78,TRUE,166,131,297,3.47
773,White,28,Male,2.36,FALSE,154,140,294,3.19
271,White,30,Female,3.24,TRUE,137,133,270,3.39
780,White,25,Female,2.66,FALSE,156,132,288,2.86
157,White,23,Male,2.35,TRUE,134,131,265,2.88
724,White,24,Trans*,2.86,TRUE,154,132,286,3.48
392,White,23,Trans*,2.8,FALSE,157,150,307,3.74
389,Bi-Racial,27,Male,2.61,TRUE,130,131,261,2.59
654,Black,24,Trans*,1.84,FALSE,156,139,295,2.42
268,White,27,Trans*,2.12,FALSE,133,150,283,1.76
046,White,30,Trans*,2.24,TRUE,147,131,278,2.77
027,White,20,Male,2.48,FALSE,165,139,304,2.51
500,White,25,Trans*,1.68,FALSE,153,146,299,3.32
610,White,27,Female,2.57,TRUE,144,136,280,2.51
589,Asian,24,Male,2.27,FALSE,154,133,287,2.63
537,White,26,Trans*,2.94,FALSE,143,139,282,2.7
341,Hispanic,30,Trans*,2.71,FALSE,147,143,290,2.98
439,Hispanic,28,Female,2.41,TRUE,132,131,263,3.65
002,Black,25,Trans*,2.82,FALSE,148,140,288,2.4
193,Asian,23,Female,2.44,FALSE,164,134,298,2.49
483,Hispanic,26,Female,2.57,TRUE,143,130,273,3.96
021,Black,22,Trans*,3.22,FALSE,140,143,283,2.76
165,White,23,Trans*,2.32,TRUE,146,140,286,3.01
333,Asian,21,Female,2.65,TRUE,150,133,283,3.31
501,Hispanic,26,Male,3.17,TRUE,145,137,282,3.46
017,White,28,Trans*,1.66,FALSE,141,130,271,3.01
359,White,23,Male,3.36,TRUE,133,136,269,3.74
565,White,26,Male,2.39,TRUE,169,142,311,2.65
324,White,28,Male,3.22,FALSE,134,132,266,3.16
524,Asian,23,Female,2.72,TRUE,130,131,261,3.58
733,White,28,Male,2.05,TRUE,132,142,274,3.49
695,White,25,Male,2.64,TRUE,131,138,269,3.97
374,Black,23,Trans*,1.73,FALSE,148,132,280,2.27
169,Black,27,Trans*,2.51,TRUE,134,151,285,3.82
676,Hispanic,24,Female,2.88,FALSE,143,130,273,3.39
104,White,29,Trans*,2.72,TRUE,147,134,281,3.21
533,Black,29,Male,3.18,FALSE,168,146,314,3.77
208,White,29,Male,2.72,FALSE,159,132,291,3.02
406,White,25,Trans*,2.85,TRUE,134,132,266,3.74
528,White,23,Male,2.07,FALSE,137,141,278,2.65
115,Hispanic,23,Trans*,2.33,FALSE,135,151,286,2.16
448,White,26,Male,2.39,FALSE,141,138,279,3.33
181,White,20,Female,2.31,TRUE,154,138,292,3.31
189,White,22,Male,3.59,FALSE,133,147,280,2.92
290,Black,24,Trans*,2.51,TRUE,156,143,299,2.93
662,Black,29,Male,2.56,FALSE,150,135,285,2.58
733,White,28,Female,3.32,FALSE,145,130,275,2.94
572,Black,27,Trans*,2.06,TRUE,169,132,301,3.32
097,White,30,Trans*,2.56,TRUE,141,137,278,3.12
375,White,27,Female,1.71,TRUE,138,134,272,3.22
505,White,26,Trans*,1.81,FALSE,146,139,285,2.63
495,Hispanic,22,Trans*,2.53,TRUE,133,131,264,3.01
461,White,20,Trans*,3.4,TRUE,143,132,275,2.76
357,White,30,Female,3.15,FALSE,130,131,261,2.4
114,White,22,Male,1.98,FALSE,156,134,290,3.05
424,Black,29,Male,2.75,FALSE,137,137,274,2.84
121,Hispanic,23,Trans*,2.28,TRUE,138,132,270,3.29
209,White,30,Male,1.99,TRUE,144,136,280,2.58
488,Hispanic,24,Female,2.8,TRUE,139,134,273,3.61
534,Asian,25,Male,2.96,FALSE,145,134,279,3.49
750,White,28,Male,2.11,FALSE,137,136,273,3.46
785,White,29,Male,2.66,FALSE,148,143,291,2.99
575,White,25,Female,2.61,FALSE,136,142,278,2.6
558,White,23,Female,2.24,TRUE,161,130,291,3.91
739,Bi-Racial,21,Male,2.34,TRUE,141,134,275,3.21
444,White,23,Female,2.26,TRUE,161,130,291,3.86
660,Hispanic,22,Male,3.57,FALSE,138,135,273,3.18
177,White,27,Male,3.17,FALSE,133,134,267,3.68
161,White,26,Female,3.77,FALSE,147,141,288,2.91
711,White,25,Female,1.94,FALSE,163,150,313,2.4
593,White,23,Male,2.54,FALSE,165,134,299,2.8
476,Bi-Racial,27,Female,1.56,TRUE,137,138,275,3.7
314,Hispanic,24,Male,2.47,FALSE,161,132,293,2.74
363,White,30,Male,2.78,FALSE,151,132,283,3.46
669,Asian,20,Trans*,1.95,FALSE,156,139,295,3.69
655,White,25,Trans*,2.68,TRUE,137,133,270,3.22
610,Hispanic,24,Female,3.06,FALSE,132,150,282,2.77
310,White,25,Trans*,2.46,FALSE,157,137,294,2.99
289,Hispanic,29,Male,2.45,TRUE,153,130,283,2.86
220,Black,21,Male,2.21,TRUE,140,131,271,3.11
175,White,20,Trans*,2.21,FALSE,135,132,267,2.19
381,White,28,Trans*,2.31,FALSE,144,146,290,3.11
723,Bi-Racial,26,Male,2.55,TRUE,139,151,290,3.81
153,Bi-Racial,27,Female,2.31,FALSE,154,133,287,2.71
237,White,25,Female,2.84,FALSE,138,134,272,3.32
217,White,30,Male,2.53,FALSE,153,133,286,2.66
001,White,30,Female,2.4,TRUE,165,142,307,3.13
184,Bi-Racial,23,Female,2.62,FALSE,154,130,284,3.11
520,White,25,Male,3.01,TRUE,166,131,297,2.7
696,Hispanic,27,Female,2.12,FALSE,139,149,288,2.89
726,Bi-Racial,24,Trans*,1.68,TRUE,150,139,289,3.62
699,White,30,Male,2.31,FALSE,144,141,285,2.37
258,White,22,Male,2.09,TRUE,144,131,275,3.83
794,White,26,Male,2.8,TRUE,139,138,277,2.39
603,Black,27,Female,2.38,FALSE,169,153,322,3.34
351,Hispanic,24,Female,3.43,FALSE,152,147,299,3.44
457,White,22,Male,2.8,FALSE,138,140,278,1.84
638,Black,30,Male,2.25,TRUE,148,130,278,3.57
128,White,23,Male,2.79,FALSE,149,136,285,3.88
277,White,20,Trans*,2.13,FALSE,144,131,275,2.82
202,White,21,Female,2.22,TRUE,143,133,276,3.37
075,White,22,Trans*,2.08,FALSE,149,138,287,2.85
251,White,25,Trans*,2.36,FALSE,144,148,292,3.17
385,White,21,Male,2.81,TRUE,163,131,294,3.41
755,White,27,Female,2.07,FALSE,131,133,264,3.42
101,White,23,Female,1.91,FALSE,154,145,299,2.41
702,Hispanic,24,Trans*,2.78,FALSE,169,132,301,3.29
380,White,24,Male,1.91,FALSE,155,138,293,3.36
401,White,23,Trans*,1.82,FALSE,132,131,263,3.26
378,White,26,Female,3.02,FALSE,141,142,283,3.19
722,White,26,Male,2.38,TRUE,144,142,286,3.65
277,Black,26,Male,2.6,TRUE,135,136,271,2.33
731,Asian,25,Female,2.54,TRUE,143,131,274,3.23
107,White,26,Male,3.61,FALSE,143,137,280,3.51
551,White,23,Male,2.4,TRUE,149,132,281,3.2
071,White,23,Male,3.04,FALSE,151,142,293,2.89
629,White,20,Male,2.53,TRUE,142,141,283,2.65
386,White,26,Male,2.71,TRUE,158,142,300,3.02
220,White,22,Female,2.45,FALSE,149,139,288,3.57
108,White,25,Trans*,1.89,TRUE,146,133,279,2.52
330,White,20,Female,2.51,FALSE,144,147,291,2.48
749,White,21,Male,1.35,TRUE,133,132,265,2.95
036,Hispanic,26,Trans*,1.53,TRUE,140,139,279,3.75
361,White,26,Female,2.75,FALSE,139,144,283,3.32
758,Black,25,Trans*,2.52,TRUE,160,141,301,3.02
199,White,24,Trans*,1.9,FALSE,139,133,272,2.83
090,Black,29,Male,2.76,FALSE,149,142,291,3.41
262,White,25,Trans*,2.82,TRUE,157,134,291,3.6
639,White,25,Trans*,1.8,TRUE,159,132,291,2.91
320,White,29,Female,2.36,FALSE,167,145,312,2.25
145,Hispanic,22,Male,2.51,FALSE,137,133,270,3.15
306,Hispanic,27,Female,3.64,FALSE,163,141,304,3.18
022,White,30,Trans*,1.79,TRUE,147,131,278,3.01
397,White,22,Trans*,1.26,TRUE,145,131,276,3.16
532,White,30,Male,2.61,TRUE,141,131,272,3.23
051,Hispanic,26,Trans*,1.75,FALSE,146,135,281,2.07
182,White,20,Female,2.72,FALSE,140,131,271,3.63
378,White,30,Female,1.6,TRUE,163,131,294,3.63
624,Black,20,Trans*,3.28,TRUE,156,133,289,3.28
718,White,30,Female,2.49,FALSE,160,132,292,3.53
151,Hispanic,28,Male,2.92,FALSE,138,133,271,2.66
125,White,22,Male,2.18,TRUE,137,136,273,3.49
577,White,21,Male,2.87,TRUE,164,135,299,3.94
664,Asian,30,Trans*,2.22,FALSE,147,138,285,2.56
155,White,24,Female,2.03,FALSE,157,132,289,3.47
419,White,27,Male,2.56,TRUE,166,139,305,3.29
580,White,30,Female,2.06,FALSE,141,134,275,2.14
080,Hispanic,30,Female,2.11,TRUE,158,133,291,3.33
645,White,28,Male,3.24,TRUE,157,141,298,3.95
109,White,22,Male,1.93,FALSE,130,134,264,3.07
307,White,27,Trans*,2.25,TRUE,154,131,285,2.05
725,White,29,Trans*,2.74,TRUE,137,131,268,3.62
346,White,21,Female,2.22,TRUE,134,136,270,3.67
782,White,29,Trans*,3.3,TRUE,153,150,303,2.96
469,White,23,Trans*,2.71,TRUE,150,136,286,3.29
126,White,23,Female,2.37,TRUE,157,131,288,2.94
735,White,24,Female,2.15,TRUE,136,132,268,3.12
056,Hispanic,21,Female,3.22,FALSE,141,142,283,3.04
509,White,25,Male,1.67,TRUE,147,137,284,3.47
159,Native,27,Trans*,3,FALSE,157,134,291,2.7
292,White,22,Male,2.01,FALSE,148,135,283,2.91
024,White,22,Male,2.97,TRUE,134,139,273,2.98
598,Hispanic,23,Male,2.82,TRUE,144,133,277,3.43
402,Native,23,Female,2.29,FALSE,140,134,274,3.44
787,Black,20,Male,3.06,FALSE,150,135,285,1.71
149,Hispanic,25,Male,2.34,FALSE,151,136,287,3.01
512,Asian,26,Female,2.76,TRUE,164,130,294,3.26
455,Hispanic,24,Trans*,1.36,TRUE,146,131,277,2.82
373,Black,24,Female,2.44,TRUE,135,133,268,3.45
009,Black,20,Male,2.35,FALSE,150,131,281,2.76
604,White,27,Trans*,2.36,FALSE,141,133,274,2.51
412,White,24,Male,2.72,FALSE,143,136,279,2.29
059,White,22,Male,2.7,TRUE,149,143,292,3.67
568,White,26,Female,3.27,TRUE,153,132,285,3.8
262,Hispanic,29,Trans*,2.67,FALSE,160,136,296,3.13
233,Black,21,Male,3.89,FALSE,139,135,274,1.71
583,White,21,Trans*,2.25,TRUE,151,146,297,2.85
609,White,20,Female,1.84,TRUE,148,153,301,3.67
550,Black,27,Female,1.97,TRUE,157,156,313,3.61
086,Black,20,Male,2.46,TRUE,135,143,278,2.75
062,White,29,Trans*,3.41,TRUE,157,137,294,2.7
403,White,27,Female,2.83,FALSE,167,134,301,3.17
074,Hispanic,22,Trans*,2.12,TRUE,141,138,279,2.74
025,Black,26,Trans*,1.46,FALSE,156,140,296,3.28
518,White,27,Trans*,2.78,TRUE,149,139,288,3.09
529,White,23,Male,2.57,FALSE,143,140,283,2.37
042,White,28,Male,1.77,FALSE,130,132,262,3.56
138,White,28,Male,2.61,TRUE,132,138,270,2.94
456,White,26,Male,2.52,FALSE,137,156,293,3.41
362,White,25,Trans*,2.32,TRUE,155,133,288,2
700,Hispanic,24,Trans*,2.7,TRUE,164,131,295,3.7
005,White,22,Trans*,2.25,FALSE,148,144,292,3.1
567,Hispanic,26,Male,2.95,TRUE,152,131,283,3.82
447,Black,22,Female,2.44,TRUE,145,133,278,2.63
006,Hispanic,25,Trans*,3.06,TRUE,161,137,298,3.16
665,White,24,Female,2.6,TRUE,150,135,285,2.88
616,White,30,Trans*,2.86,TRUE,150,134,284,2.86
655,White,29,Male,2.58,FALSE,145,138,283,3.77
311,Black,30,Female,2.41,TRUE,156,145,301,3.58
551,White,24,Trans*,2.41,FALSE,136,140,276,1.97
467,White,24,Trans*,1.94,TRUE,156,134,290,3.34
031,White,25,Trans*,2.32,FALSE,151,139,290,2.95
094,White,22,Male,1.83,TRUE,141,141,282,2.95
227,White,22,Female,2.22,FALSE,142,133,275,2.65
581,Black,28,Male,2.79,FALSE,157,133,290,2.37
306,White,23,Female,2.23,TRUE,132,134,266,3.77
524,White,30,Male,1.75,FALSE,139,145,284,3.27
164,White,28,Trans*,1.62,TRUE,148,138,286,3.26
214,White,27,Female,2.84,FALSE,155,135,290,2.01
231,Hispanic,22,Female,1.61,TRUE,131,130,261,3.3
751,White,30,Male,2.49,TRUE,144,130,274,2.31
184,White,25,Trans*,2.32,TRUE,138,147,285,3.65
387,White,27,Female,2.76,FALSE,147,148,295,2.95
073,White,22,Male,2.59,FALSE,133,133,266,2.62
273,White,27,Male,1.62,TRUE,159,135,294,3.02
726,White,27,Male,2.47,FALSE,152,131,283,3.54
784,White,28,Male,1.83,FALSE,153,134,287,2.72
584,Black,21,Male,2.76,FALSE,169,138,307,3.81
680,Asian,21,Male,2.74,TRUE,143,131,274,3.32
762,Asian,25,Female,2.65,FALSE,151,132,283,2.35
562,Native,28,Trans*,2.93,TRUE,139,135,274,2.98
462,Black,23,Female,1.95,TRUE,137,132,269,3.35
481,White,21,Male,2.77,FALSE,149,139,288,2.94
353,White,20,Male,2.5,FALSE,166,142,308,2.8
590,White,20,Trans*,3.23,FALSE,148,137,285,2.55
648,White,27,Trans*,2.12,FALSE,151,130,281,3.39
245,Bi-Racial,28,Male,2.97,TRUE,164,149,313,3.5
621,Asian,24,Male,2.14,TRUE,140,133,273,2.86
377,Hispanic,21,Trans*,2.9,TRUE,153,132,285,2.2
028,White,20,Female,2.41,FALSE,139,136,275,2.96
690,White,30,Male,2.45,TRUE,161,132,293,3.51
011,White,30,Female,3.03,FALSE,156,131,287,3.54
267,White,23,Trans*,2.43,FALSE,145,132,277,2.86
327,White,28,Trans*,1.7,FALSE,142,137,279,3.35
741,White,29,Female,2.17,TRUE,133,152,285,3.6
490,White,21,Male,2.6,FALSE,145,146,291,2.56
472,White,21,Male,3.15,TRUE,164,152,316,3.92
765,White,30,Female,2.61,FALSE,142,132,274,2.77
589,Asian,23,Trans*,2.89,TRUE,137,135,272,3.08
200,White,25,Male,2.44,FALSE,169,135,304,1.74
070,White,20,Male,2.18,TRUE,131,143,274,3.35
141,White,29,Trans*,3.01,FALSE,131,132,263,3.12
016,White,25,Female,2.33,FALSE,143,132,275,2.09
586,White,20,Trans*,2.3,FALSE,140,135,275,3.33
712,White,24,Trans*,2.41,FALSE,149,132,281,3.29
328,White,20,Male,2.8,TRUE,131,144,275,3.31
437,White,29,Trans*,1.31,TRUE,152,139,291,3.9
188,White,29,Female,2.64,FALSE,133,132,265,2.49
407,White,28,Female,2.64,FALSE,130,135,265,3.07
256,White,22,Female,3.45,TRUE,149,146,295,3.02
052,White,20,Male,2.53,TRUE,152,135,287,3.67
763,White,28,Male,2.91,TRUE,150,140,290,3.29
515,White,26,Trans*,2.97,FALSE,144,135,279,2.34
240,White,24,Male,2.39,FALSE,143,137,280,3.03
504,White,20,Male,2.55,FALSE,149,141,290,3.19
322,Black,26,Male,2.5,TRUE,136,143,279,2.78
170,White,21,Female,2.28,FALSE,143,134,277,2.52
300,White,24,Female,2.42,FALSE,160,131,291,3.15
141,White,30,Male,1.66,TRUE,152,144,296,3.33
424,White,24,Trans*,2.13,TRUE,143,131,274,3.62
587,White,25,Male,2.09,FALSE,166,139,305,3.05
348,Hispanic,25,Trans*,2.54,TRUE,132,138,270,3.72
585,White,21,Female,3.54,FALSE,135,133,268,2.27
297,Hispanic,29,Female,1.56,TRUE,150,140,290,2.99
685,Asian,26,Trans*,2.74,FALSE,163,145,308,2.8
002,White,28,Female,2.52,TRUE,143,130,273,3.59
310,Hispanic,23,Female,2.74,TRUE,166,138,304,3.3
613,White,23,Trans*,2.58,TRUE,156,131,287,3.12
561,White,25,Male,2.38,TRUE,153,137,290,2.16
709,White,21,Male,2.13,TRUE,145,136,281,3.84
643,Hispanic,24,Male,1.94,FALSE,146,132,278,2.98
326,White,27,Female,2.97,FALSE,146,136,282,2.93
601,White,30,Trans*,2.78,FALSE,158,136,294,3.47
396,Black,20,Male,3.61,TRUE,169,133,302,3.3
079,White,22,Male,2.03,TRUE,146,130,276,3.18
482,Black,27,Male,1.49,FALSE,144,142,286,3.33
044,Black,23,Female,2.69,FALSE,137,132,269,2.93
407,Hispanic,30,Trans*,2.59,TRUE,143,135,278,2.85
039,Black,28,Female,2.61,FALSE,166,131,297,3.39
513,Asian,30,Female,2.28,TRUE,148,139,287,3.23
253,White,30,Female,3.07,FALSE,150,132,282,3.32
703,Hispanic,25,Male,3.04,FALSE,140,131,271,2.92
279,Native,21,Female,1.39,FALSE,157,140,297,3.05
605,White,30,Male,2.37,TRUE,138,131,269,3.15
129,White,26,Trans*,2.33,FALSE,157,145,302,2.45
009,Hispanic,23,Trans*,2.15,TRUE,143,135,278,3.82
781,White,23,Male,2.87,FALSE,133,141,274,2.64
338,White,25,Trans*,2.36,FALSE,161,137,298,2.9
773,Black,25,Female,1.87,TRUE,141,133,274,3.77
019,White,22,Trans*,3.1,TRUE,164,132,296,2.56
232,White,23,Female,2.55,FALSE,157,148,305,3.36
233,White,28,Male,2.35,TRUE,141,140,281,3.79
463,White,25,Trans*,3.39,TRUE,165,137,302,3.84
347,White,28,Female,1.82,TRUE,164,140,304,3.91
701,White,29,Trans*,2.59,TRUE,157,132,289,3.22
278,White,22,Male,3.2,FALSE,153,132,285,2.81
026,White,30,Male,2.42,FALSE,152,137,289,2.49
782,White,21,Trans*,3.21,FALSE,146,131,277,3.41
060,Black,23,Trans*,2.08,TRUE,149,132,281,3.93
054,Black,23,Male,3.31,FALSE,131,137,268,3.63
111,Hispanic,22,Female,2.27,TRUE,159,133,292,3.82
343,White,28,Female,3.05,TRUE,144,140,284,3
325,White,29,Trans*,2.5,TRUE,157,131,288,3.57
445,White,22,Male,2.41,FALSE,163,132,295,3.18
176,Hispanic,21,Female,2.13,TRUE,136,138,274,3.61
004,Asian,23,Male,2.38,FALSE,167,134,301,2.58
225,White,23,Female,2.84,TRUE,136,145,281,2.96
372,White,26,Male,1.92,FALSE,149,131,280,2.98
083,White,22,Female,2.71,TRUE,150,149,299,3.93
778,Black,26,Male,1.56,FALSE,134,133,267,1.98
540,Black,24,Trans*,2.69,FALSE,144,156,300,2.52
305,White,20,Female,2.52,FALSE,156,135,291,3.29
460,White,30,Female,2.9,FALSE,152,141,293,2.8
503,White,20,Trans*,2.6,FALSE,151,134,285,2.6
398,White,25,Female,2.74,FALSE,139,130,269,3.82
618,White,29,Trans*,2.98,FALSE,140,131,271,2.67
326,White,23,Male,1.64,TRUE,145,142,287,3.38
190,Hispanic,29,Male,2.49,TRUE,136,132,268,3.56
091,Black,21,Male,2.57,FALSE,145,134,279,2.83
786,Hispanic,22,Female,2.95,TRUE,158,140,298,2.96
477,Black,28,Female,2.68,FALSE,142,135,277,3.56
321,White,21,Female,3.06,FALSE,136,134,270,2.87
236,White,22,Male,2.76,TRUE,170,130,300,3.61
625,White,29,Male,3.47,TRUE,151,140,291,3.68
322,White,23,Trans*,3.11,FALSE,157,130,287,3.21
187,Black,27,Female,2.34,TRUE,160,131,291,3.14
486,White,21,Trans*,3.2,FALSE,155,139,294,2.39
616,Black,24,Female,2.76,FALSE,142,138,280,3.26
694,White,21,Female,3.57,TRUE,157,134,291,2.21
329,Hispanic,20,Male,1.34,TRUE,133,136,269,2.53
678,Black,22,Trans*,2.97,TRUE,130,142,272,2.69
023,White,30,Female,3.97,TRUE,143,140,283,3.72
527,White,21,Female,2.52,TRUE,150,139,289,2.76
431,White,29,Male,1.88,FALSE,157,131,288,2.04
443,Hispanic,25,Trans*,2.27,TRUE,156,138,294,3.05
325,Hispanic,30,Male,2.09,FALSE,135,134,269,3.48
774,White,25,Male,2.56,TRUE,162,145,307,2.78
099,Black,23,Female,1.66,FALSE,140,137,277,3.21
191,White,27,Trans*,2.25,FALSE,156,136,292,3.33
414,White,20,Trans*,2.41,TRUE,160,138,298,3.16
390,White,22,Trans*,2.8,FALSE,143,136,279,2.97
505,Hispanic,22,Trans*,2.01,TRUE,135,130,265,2.51
204,Hispanic,20,Female,3.17,FALSE,133,135,268,3.83
663,White,29,Female,3.45,FALSE,163,140,303,3.36
536,Bi-Racial,24,Male,2.91,FALSE,164,133,297,3.09
746,Black,20,Male,2.69,FALSE,155,147,302,1.96
651,White,29,Trans*,2.58,TRUE,155,136,291,3.51
038,White,20,Trans*,2.91,TRUE,149,138,287,2.74
606,Hispanic,29,Male,2.4,FALSE,153,149,302,3.18
137,Hispanic,30,Female,2.43,FALSE,166,131,297,2.72
174,White,20,Female,1.99,FALSE,158,141,299,3.33
661,White,27,Male,3.03,TRUE,167,136,303,3.68
435,White,22,Female,2.39,TRUE,141,144,285,2.64
670,Hispanic,23,Trans*,3.09,TRUE,145,131,276,3.4
029,Asian,25,Trans*,2.01,FALSE,152,139,291,3.22
761,White,25,Trans*,2.84,TRUE,156,152,308,3.46
022,White,20,Female,2.61,FALSE,140,148,288,3.49
082,White,29,Trans*,3.39,TRUE,163,134,297,3.33
777,Black,23,Female,3.05,FALSE,159,138,297,2.89
264,White,25,Trans*,2.65,FALSE,161,137,298,3.81
047,White,24,Male,3.75,FALSE,143,136,279,3.03
229,White,27,Trans*,2.63,FALSE,164,149,313,2.83
139,Black,25,Trans*,2.5,FALSE,160,134,294,2.4
234,White,20,Trans*,2.36,FALSE,152,131,283,3.2
014,Asian,24,Female,1.87,TRUE,142,135,277,3.58
286,White,27,Trans*,2.25,TRUE,146,132,278,3.27
260,Bi-Racial,27,Trans*,3.49,FALSE,157,134,291,2.25
758,Black,24,Female,2.84,FALSE,134,130,264,2.03
529,White,28,Male,1.96,TRUE,169,137,306,3.58
371,Bi-Racial,27,Male,2.91,TRUE,145,139,284,3.35
050,Hispanic,30,Male,3.06,TRUE,140,134,274,3.61
416,White,25,Female,3.14,TRUE,138,138,276,3.2
731,White,23,Trans*,2.91,FALSE,147,138,285,2.44
118,White,21,Trans*,1.7,FALSE,144,131,275,2.44
112,White,25,Male,2.92,FALSE,166,144,310,2.14
331,Hispanic,29,Trans*,2.82,FALSE,163,142,305,2.68
125,White,23,Male,3.17,FALSE,140,138,278,3.37
485,White,22,Trans*,2.63,TRUE,137,145,282,2.55
792,White,28,Male,2.61,TRUE,145,136,281,3.99
242,Hispanic,30,Female,1.88,FALSE,131,134,265,3.78
539,Hispanic,20,Female,2.73,TRUE,135,135,270,3.02
538,White,27,Female,3.56,FALSE,145,134,279,3.39
305,Asian,24,Male,2.47,TRUE,141,143,284,1.88
751,Black,25,Trans*,2.97,FALSE,142,141,283,3.69
532,White,23,Male,3.16,FALSE,161,140,301,3.58
209,White,26,Trans*,2.25,FALSE,134,143,277,3.66
415,White,22,Male,2.21,FALSE,153,143,296,2.23
048,White,25,Male,2.37,TRUE,148,147,295,3.8
278,White,25,Trans*,2.92,TRUE,136,139,275,3.86
109,White,20,Trans*,2.46,TRUE,142,147,289,3.58
176,Black,26,Female,2.45,FALSE,162,139,301,2.53
255,White,25,Female,3.64,TRUE,153,132,285,3.25
123,Native,21,Female,3.31,TRUE,131,133,264,3.05
077,White,28,Male,2.04,FALSE,170,131,301,2.85
612,Black,28,Trans*,2.54,TRUE,152,138,290,3.36
217,Hispanic,21,Female,3.3,TRUE,142,132,274,2.54
246,White,27,Trans*,3.54,TRUE,134,130,264,3.09
525,White,23,Male,2.99,TRUE,135,134,269,3.04
788,White,20,Female,1.73,TRUE,140,145,285,3.52
684,White,21,Trans*,2.99,FALSE,149,131,280,3.25
212,White,27,Trans*,2.78,FALSE,153,133,286,3.86
554,White,27,Male,2.28,FALSE,131,131,262,2.84
431,Hispanic,24,Trans*,2.64,TRUE,146,135,281,3.25
066,Black,28,Female,2.55,FALSE,148,141,289,2.97
087,White,22,Female,2.69,FALSE,154,133,287,3.84
754,Black,29,Female,3.16,TRUE,152,130,282,2.79
342,White,26,Male,2.56,TRUE,153,132,285,2.8
248,White,27,Female,2.16,TRUE,149,136,285,3.6
050,Asian,22,Trans*,1.84,FALSE,153,133,286,3.07
624,White,22,Male,3.05,FALSE,152,141,293,3.66
744,White,29,Male,1.84,FALSE,142,135,277,3.81
415,Black,29,Trans*,3.14,TRUE,160,135,295,3.26
046,White,28,Male,2.59,FALSE,131,150,281,2.25
132,White,25,Female,2.91,FALSE,145,153,298,2.67
346,Asian,25,Female,2.62,FALSE,159,130,289,2.97
717,White,22,Trans*,3.61,TRUE,151,132,283,3.93
166,White,22,Trans*,3.34,TRUE,155,133,288,3.04
459,White,22,Trans*,2.17,TRUE,155,131,286,2.65
742,White,20,Male,2.5,TRUE,131,154,285,2.75
078,White,30,Male,2.06,FALSE,152,131,283,2.82
769,Black,24,Male,2.06,FALSE,159,135,294,2.61
084,Black,27,Trans*,2.15,FALSE,145,141,286,3.11
495,Hispanic,23,Male,2.34,FALSE,164,133,297,3.31
383,White,25,Male,3.39,FALSE,152,143,295,2.65
433,Hispanic,28,Female,3.11,FALSE,148,132,280,2.85
583,Hispanic,30,Trans*,2.42,FALSE,149,146,295,3.95
294,White,27,Female,2.63,TRUE,154,132,286,3.75
339,Asian,23,Male,2.59,TRUE,168,136,304,3.53
149,Bi-Racial,20,Male,2.46,TRUE,142,131,273,3.19
678,White,28,Male,2.8,FALSE,144,134,278,3.32
082,White,22,Male,2.37,FALSE,150,135,285,2.89
364,White,27,Female,2.44,FALSE,142,140,282,3.33
426,White,28,Male,3.15,TRUE,143,146,289,2.99
124,White,23,Male,2.52,FALSE,141,132,273,3.03
692,Asian,21,Male,2.14,FALSE,142,140,282,2.54
490,White,22,Trans*,2.11,TRUE,142,140,282,3.39
290,White,21,Trans*,1.78,FALSE,147,163,310,3.53
749,Black,26,Trans*,2.14,FALSE,143,133,276,2.76
405,Bi-Racial,23,Trans*,2.3,FALSE,149,135,284,3.45
709,White,25,Male,2.26,FALSE,134,132,266,3.42
563,Hispanic,21,Trans*,3.39,TRUE,153,131,284,3.28
652,White,23,Male,2.42,FALSE,155,132,287,2.86
225,Black,20,Female,2.27,FALSE,130,134,264,3.96
631,Hispanic,28,Female,1.78,FALSE,133,142,275,2.99
377,White,22,Male,2.68,FALSE,163,141,304,2.86
345,White,23,Female,2.81,FALSE,155,140,295,2.71
724,White,28,Trans*,2.26,FALSE,149,142,291,3.02
403,Hispanic,22,Male,2.43,TRUE,153,139,292,2.5
714,White,24,Male,2.36,TRUE,150,151,301,3.17
608,White,28,Male,2.84,FALSE,162,143,305,2.98
543,White,25,Female,3.18,FALSE,138,143,281,3.77
605,White,22,Female,2.39,FALSE,153,142,295,2.75
093,Black,27,Trans*,3.34,FALSE,144,134,278,2.02
760,White,29,Trans*,2.67,TRUE,152,141,293,3.84
497,White,26,Male,2.4,TRUE,145,131,276,3.78
665,Hispanic,23,Female,2.44,FALSE,143,131,274,3.05
619,Hispanic,24,Trans*,2.9,TRUE,157,130,287,3.47
192,Hispanic,26,Male,2.76,FALSE,162,136,298,2.67
023,White,25,Trans*,2.75,FALSE,131,136,267,3.01
774,Hispanic,30,Male,3.04,FALSE,148,133,281,2.73
629,White,30,Trans*,2.62,FALSE,146,141,287,2.35
243,White,25,Female,2.6,FALSE,165,132,297,2.98
332,Hispanic,25,Trans*,2.69,FALSE,142,132,274,2.75
648,Black,20,Female,1.79,TRUE,153,135,288,3.45
659,White,22,Female,2.34,FALSE,138,138,276,2.58
766,White,29,Male,2.55,TRUE,153,132,285,3.15
058,White,20,Male,1.95,FALSE,155,133,288,3.19
664,White,27,Female,2.51,TRUE,148,144,292,3.2
206,White,27,Trans*,2.12,FALSE,158,130,288,3.28
641,White,29,Female,2.04,FALSE,138,134,272,3.41
430,Bi-Racial,23,Trans*,2.72,FALSE,138,141,279,3.68
499,White,28,Male,3.44,TRUE,136,138,274,3.29
116,Black,21,Female,2.04,TRUE,140,136,276,3.6
236,White,24,Male,2.61,FALSE,161,141,302,2.95
248,Black,26,Trans*,2.92,FALSE,147,144,291,2.84
197,White,28,Female,2.46,FALSE,152,141,293,2.74
021,White,20,Female,2.62,TRUE,149,138,287,3.77
588,White,28,Trans*,2.96,FALSE,155,131,286,2.4
362,White,30,Male,2.19,FALSE,166,138,304,2.64
705,White,28,Trans*,2.97,FALSE,136,133,269,2.02
767,Asian,23,Trans*,3.97,TRUE,136,136,272,3.27
668,White,22,Trans*,3.14,TRUE,135,135,270,3.24
269,White,28,Female,3.01,FALSE,140,134,274,2.99
218,White,22,Trans*,2.15,FALSE,159,135,294,2.58
510,Black,30,Female,3.23,FALSE,148,137,285,2.84
711,Hispanic,25,Female,3.14,TRUE,159,135,294,3.33
644,Hispanic,21,Male,1.9,FALSE,148,131,279,2.69
576,Hispanic,30,Male,1.33,FALSE,156,144,300,2.12
404,White,30,Male,2.81,FALSE,149,131,280,3.17
392,Hispanic,27,Female,2.67,TRUE,154,134,288,3.39
228,White,20,Female,2.98,TRUE,149,139,288,3.51
423,White,28,Female,1.47,TRUE,142,137,279,3.12
150,White,25,Female,1.95,TRUE,157,135,292,3.27
012,White,29,Female,2.31,TRUE,151,150,301,2.86
056,White,29,Male,1.84,TRUE,151,140,291,3.37
685,Black,30,Trans*,2.41,TRUE,137,134,271,2.52
127,Asian,21,Trans*,2.94,FALSE,151,136,287,3.65
487,Hispanic,24,Trans*,2.82,TRUE,131,131,262,3.33
556,Bi-Racial,27,Female,3.37,TRUE,140,131,271,3
336,White,27,Female,3.14,TRUE,138,131,269,2.53
498,White,26,Male,2.61,TRUE,155,142,297,3.58
358,Hispanic,26,Male,3.4,TRUE,135,138,273,4
698,Black,28,Male,2.14,FALSE,153,139,292,2.46
395,White,20,Female,1.95,FALSE,160,137,297,3.18
083,White,26,Male,2.18,FALSE,135,137,272,2.59
037,White,26,Trans*,2.36,TRUE,155,147,302,2.63
737,White,25,Male,2.67,TRUE,147,135,282,2.72
400,White,21,Female,2.77,TRUE,159,133,292,3.25
530,White,25,Female,2.49,FALSE,151,131,282,3.44
778,White,20,Trans*,2.48,TRUE,148,133,281,2.49
100,Other,21,Trans*,1.96,FALSE,139,134,273,2.99
635,Black,25,Male,1.89,FALSE,130,135,265,2.82
183,White,24,Male,2.59,TRUE,132,137,269,3.23
271,White,23,Trans*,2.8,FALSE,167,143,310,2.71
118,White,27,Male,2.54,TRUE,151,152,303,3.48
006,White,27,Male,2.11,FALSE,132,137,269,2.87
073,White,30,Male,2.99,TRUE,156,141,297,3.52
301,White,21,Female,2.17,FALSE,132,135,267,2.61
543,Asian,27,Female,2.9,TRUE,142,132,274,2.93
173,White,25,Female,3.12,FALSE,150,140,290,3.52
656,White,30,Male,1.67,TRUE,146,136,282,2.97
232,White,20,Trans*,2.08,TRUE,144,134,278,3.31
307,Black,20,Female,2.55,FALSE,141,132,273,2.41
008,White,23,Female,3.64,FALSE,137,131,268,2.58
682,White,27,Male,2.32,TRUE,160,130,290,3.44
186,White,28,Female,2.24,TRUE,163,135,298,2.61
323,Black,29,Trans*,1.91,FALSE,155,136,291,3.69
391,White,26,Female,1.87,FALSE,136,131,267,3.05
318,White,23,Female,2.8,TRUE,132,167,299,3.31
617,Hispanic,24,Male,2.42,FALSE,151,138,289,2.54
428,White,29,Trans*,2.64,FALSE,152,144,296,3.26
017,White,25,Female,2.31,TRUE,161,142,303,3.48
793,Hispanic,23,Female,1.68,TRUE,151,148,299,3.47
417,White,23,Female,1.89,TRUE,161,131,292,2.81
369,Black,27,Trans*,3.43,TRUE,138,133,271,2.88
342,White,24,Female,2.14,FALSE,146,132,278,2.43
748,White,25,Trans*,2.71,FALSE,145,134,279,3.7
552,White,22,Trans*,3.52,TRUE,139,131,270,3.3
213,Hispanic,21,Male,3.03,FALSE,145,130,275,2.5
412,Black,20,Trans*,2.72,TRUE,162,138,300,2.89
194,White,30,Male,2.07,FALSE,149,139,288,2.16
207,White,28,Female,2.17,FALSE,167,132,299,3.66
078,White,29,Trans*,2.74,TRUE,161,134,295,2.07
180,White,29,Female,2.89,TRUE,148,130,278,2.8
049,White,29,Trans*,2.96,TRUE,166,136,302,3.56
142,Bi-Racial,28,Trans*,1.79,TRUE,145,131,276,3.56
116,Black,25,Trans*,2.8,FALSE,163,130,293,2.61
399,White,29,Female,2.47,TRUE,137,149,286,2.67
596,Hispanic,21,Male,3.72,TRUE,135,146,281,3.08
020,White,20,Male,2.88,TRUE,159,134,293,3.4
131,White,20,Trans*,3.33,FALSE,163,135,298,3.18
732,White,29,Female,2.76,TRUE,136,133,269,3.24
434,Asian,30,Trans*,3.07,TRUE,147,136,283,3.58
752,White,25,Trans*,2.79,FALSE,136,149,285,3.36
213,White,22,Female,3.06,TRUE,138,130,268,3.17
121,White,27,Trans*,2.7,FALSE,154,151,305,2.88
084,White,20,Male,2.45,TRUE,152,132,284,3.4
358,Asian,23,Trans*,2.46,FALSE,161,132,293,3.19
657,Black,29,Female,2.59,TRUE,138,138,276,3
226,Hispanic,21,Female,2.9,FALSE,148,138,286,2.54
059,White,21,Female,2.1,FALSE,130,131,261,3.06
267,Hispanic,30,Female,2.34,TRUE,131,133,264,3.29
197,Black,20,Trans*,2.63,TRUE,146,142,288,2.79
237,Hispanic,28,Female,1.85,TRUE,158,143,301,2.81
396,White,21,Trans*,2.97,FALSE,145,145,290,2.57
606,White,24,Female,2.56,TRUE,159,146,305,3.67
468,White,22,Male,2.7,TRUE,153,135,288,2.6
451,White,21,Trans*,2.15,TRUE,152,139,291,3.54
011,Hispanic,24,Trans*,2.34,TRUE,157,143,300,2.45
249,Asian,26,Female,2.44,FALSE,146,138,284,2.51
091,White,27,Female,2.39,TRUE,135,143,278,3.17
759,White,22,Female,2.42,FALSE,136,131,267,3.56
478,White,20,Male,2.28,FALSE,166,132,298,3.02
646,Hispanic,24,Male,1.77,FALSE,143,131,274,2.9
282,White,30,Female,2.4,TRUE,140,144,284,2.57
052,White,20,Female,2.12,FALSE,160,133,293,3.47
007,White,26,Female,3.4,TRUE,149,134,283,2.7
042,Hispanic,20,Male,2.07,TRUE,151,134,285,2
498,Black,24,Trans*,2.93,FALSE,156,132,288,2.8
462,Hispanic,21,Female,2.31,FALSE,158,132,290,3.13
005,Black,29,Male,3.39,TRUE,161,134,295,3.55
268,White,22,Trans*,3.5,TRUE,148,141,289,2.48
178,White,23,Female,1.93,FALSE,131,141,272,3.61
241,White,21,Male,2.07,FALSE,133,131,264,2.87
579,White,30,Female,2.12,TRUE,133,135,268,3.35
723,White,21,Male,2.16,FALSE,138,146,284,3.47
701,Asian,28,Female,3,FALSE,143,136,279,3.07
454,Hispanic,24,Trans*,1.93,FALSE,155,135,290,2.6
653,Hispanic,30,Female,2.48,FALSE,146,131,277,2.98
119,White,26,Male,1.8,FALSE,157,132,289,1.52
410,White,26,Male,1.82,TRUE,151,132,283,3.5
313,White,29,Male,2.3,TRUE,132,139,271,2.96
095,Bi-Racial,30,Female,2.44,FALSE,151,133,284,2.67
216,Asian,28,Male,2.1,TRUE,142,132,274,2.63
414,White,22,Female,2.88,FALSE,142,135,277,2.08
464,White,26,Female,2.38,FALSE,135,144,279,1.68
263,White,27,Male,2.49,TRUE,159,130,289,3.26
272,Hispanic,26,Trans*,2.48,TRUE,163,139,302,3.28
061,Black,20,Trans*,2.98,TRUE,139,157,296,3.37
556,Hispanic,20,Trans*,2.48,FALSE,161,137,298,3.04
643,White,30,Female,2.85,TRUE,156,134,290,3.29
179,White,24,Male,2.78,TRUE,137,137,274,3.9
535,White,20,Female,2.51,FALSE,159,132,291,3.47
281,White,25,Female,2.87,TRUE,139,141,280,3.26
677,White,24,Trans*,1.94,TRUE,146,145,291,3.51
571,Hispanic,24,Trans*,2.99,FALSE,134,131,265,3.91
458,Hispanic,23,Male,2.85,FALSE,166,138,304,2.46
475,White,24,Trans*,2.87,FALSE,154,134,288,3.05
755,White,20,Trans*,3.24,TRUE,145,137,282,3.36
243,White,21,Male,3.65,TRUE,142,132,274,2.95
106,White,29,Trans*,2.21,FALSE,147,147,294,2.77
013,White,20,Female,2.91,FALSE,161,131,292,3.08
783,White,23,Trans*,2.27,TRUE,146,141,287,3.25
511,White,28,Trans*,2.26,FALSE,131,148,279,3.14
690,White,27,Female,3.14,FALSE,160,143,303,3.07
512,Hispanic,21,Female,1.93,FALSE,158,134,292,3.39
560,Hispanic,29,Female,2.08,FALSE,141,134,275,3.16
128,White,23,Female,3.4,TRUE,162,130,292,2.98
340,White,28,Trans*,3.18,TRUE,132,134,266,3.58
502,Hispanic,24,Trans*,2.62,TRUE,141,137,278,3.51
662,Asian,20,Trans*,3.03,TRUE,151,132,283,2.97
534,Hispanic,28,Female,1.32,TRUE,158,133,291,3.9
219,White,20,Male,2.01,TRUE,154,137,291,3.64
191,Hispanic,30,Male,2.75,TRUE,160,132,292,3.3
626,White,29,Male,3.28,FALSE,142,135,277,3.07
555,Black,20,Trans*,2.55,TRUE,148,134,282,3.33
667,Hispanic,23,Female,2.76,TRUE,146,136,282,3.44
522,White,20,Trans*,2.62,TRUE,149,130,279,3.66
772,Black,24,Male,1.34,TRUE,139,137,276,3.49
016,Black,23,Female,2.22,TRUE,149,131,280,3.39
764,White,24,Female,2.89,FALSE,149,135,284,2.95
099,White,30,Male,2.63,TRUE,144,144,288,3.19
053,White,26,Female,2.34,FALSE,155,135,290,2.55
691,White,29,Male,2.74,FALSE,139,150,289,3.29
088,Bi-Racial,30,Male,2.6,FALSE,141,136,277,2.37
453,White,29,Trans*,2.12,FALSE,141,135,276,3.26
337,White,29,Trans*,2.02,TRUE,155,134,289,3.62
439,Hispanic,28,Trans*,1.87,FALSE,139,133,272,2.54
072,White,21,Female,3.13,FALSE,168,132,300,2.82
155,White,30,Trans*,2.41,TRUE,134,130,264,3.99
296,Hispanic,23,Trans*,2.42,TRUE,135,134,269,3.27
440,Hispanic,22,Trans*,1.25,FALSE,143,130,273,3.54
657,White,22,Male,2.58,FALSE,153,131,284,2.85
736,Hispanic,23,Male,2.84,TRUE,148,137,285,3.46
491,White,25,Male,2.26,TRUE,157,156,313,3.27
480,White,26,Female,2.31,TRUE,165,131,296,3.34
720,White,23,Trans*,2.74,FALSE,130,130,260,2.24
187,White,24,Female,2.18,FALSE,136,143,279,2.12
640,Black,30,Female,2.83,FALSE,131,153,284,3.93
066,Hispanic,21,Male,2.58,TRUE,154,142,296,3.81
034,White,22,Female,2.11,FALSE,131,140,271,3.75
537,Hispanic,21,Male,2.11,TRUE,155,133,288,3.68
254,Bi-Racial,30,Female,3.03,FALSE,164,132,296,3.16
591,White,28,Female,2.99,FALSE,140,131,271,3.19
270,Hispanic,27,Female,2.99,TRUE,145,135,280,2.99
687,White,30,Trans*,2.24,FALSE,131,145,276,2.61
182,White,25,Male,1.94,TRUE,130,143,273,3.11
266,White,26,Male,3.07,TRUE,160,130,290,3.55
393,Black,27,Male,2.61,FALSE,148,135,283,2.67
297,White,20,Trans*,3,FALSE,149,133,282,2.49
157,White,23,Trans*,2.36,FALSE,138,131,269,2.96
196,White,24,Trans*,2.5,FALSE,150,163,313,2.36
367,Hispanic,27,Female,2.38,TRUE,148,144,292,3.69
771,Black,30,Trans*,3,TRUE,157,130,287,2.28
029,Black,20,Female,2.69,TRUE,150,138,288,3.38
040,White,26,Female,2.79,FALSE,159,139,298,3.66
375,White,21,Male,2.04,FALSE,137,134,271,3.75
288,White,25,Male,2.75,TRUE,157,145,302,3.54
449,White,23,Male,2.73,TRUE,143,149,292,3.53
263,Black,20,Male,1.9,FALSE,156,138,294,2.54
418,White,29,Trans*,1.97,FALSE,165,130,295,3.32
033,White,22,Male,3.38,FALSE,146,136,282,2.9
064,Hispanic,26,Male,3.41,FALSE,149,132,281,2.43
303,White,27,Female,3.18,TRUE,144,131,275,2.77
757,White,24,Female,1.97,FALSE,158,130,288,3.18
064,White,24,Male,3.08,TRUE,151,140,291,2.82
740,Asian,25,Female,2.2,TRUE,148,131,279,3.53
502,Hispanic,26,Trans*,2.11,FALSE,146,149,295,3.34
247,White,21,Female,2.25,FALSE,137,141,278,3.24
776,White,30,Trans*,1.55,FALSE,143,139,282,2.3
110,White,29,Female,3.18,TRUE,137,133,270,3.94
384,White,23,Female,2.94,FALSE,163,135,298,3.74
433,White,20,Trans*,2.97,TRUE,143,150,293,3.61
275,White,22,Trans*,2.8,TRUE,158,138,296,3.26
492,Hispanic,25,Male,1.99,TRUE,153,130,283,2.49
623,White,25,Male,1.65,FALSE,145,134,279,2.99
444,White,27,Male,1.98,FALSE,143,134,277,2.99
766,White,22,Female,2.32,FALSE,164,136,300,2.9
351,White,26,Trans*,2.39,TRUE,134,141,275,3.81
735,White,22,Trans*,3.73,FALSE,162,149,311,3.3
747,White,25,Female,2.04,TRUE,143,136,279,2.53
429,White,29,Male,2.34,FALSE,153,141,294,2.46
183,White,27,Trans*,2.14,FALSE,155,131,286,2.12
553,Asian,23,Trans*,3.34,FALSE,168,132,300,3.3
189,White,28,Trans*,2.17,TRUE,142,132,274,3.44
695,White,30,Female,2.39,FALSE,132,151,283,2.46
754,White,26,Male,2.95,FALSE,149,135,284,2.52
471,White,23,Female,2.36,FALSE,141,137,278,3.58
461,White,22,Female,3.05,FALSE,151,145,296,2.37
334,White,30,Male,3.28,TRUE,143,131,274,3.1
380,Hispanic,30,Female,3.28,TRUE,160,138,298,2.25
691,Black,28,Female,2.31,TRUE,136,138,274,3.09
105,White,25,Trans*,2.79,TRUE,143,133,276,3.02
171,Hispanic,23,Female,1.67,TRUE,148,141,289,3.41
572,White,29,Male,2.62,FALSE,146,139,285,2.79
647,White,20,Female,3.12,TRUE,135,132,267,3.06
786,White,25,Trans*,2.01,FALSE,144,137,281,2.28
642,White,30,Male,2.35,FALSE,161,135,296,2.95
350,White,21,Trans*,2.86,TRUE,153,130,283,3.07
527,White,23,Female,1.69,FALSE,150,139,289,2.78
634,Hispanic,24,Female,2.12,FALSE,164,135,299,2.46
190,Asian,30,Male,2.23,FALSE,150,144,294,3.19
129,White,26,Female,2.52,TRUE,136,147,283,2.79
211,White,29,Trans*,2.38,TRUE,144,130,274,2.67
086,White,21,Male,2.63,FALSE,135,141,276,2.55
753,White,30,Female,3.34,TRUE,155,148,303,3.32
539,Black,21,Male,2.63,FALSE,139,134,273,3.18
453,Other,22,Trans*,2.4,TRUE,147,133,280,3
661,White,29,Trans*,2.92,FALSE,157,136,293,2.16
202,White,26,Female,2,FALSE,151,135,286,3
302,White,24,Trans*,3.32,FALSE,160,131,291,3.69
370,Hispanic,20,Male,2.3,TRUE,146,139,285,3.41
615,Black,20,Male,2.11,FALSE,134,138,272,3.21
274,Hispanic,21,Female,2.2,TRUE,164,139,303,2.59
688,White,30,Trans*,2.1,TRUE,168,137,305,3.92
677,White,24,Trans*,1.96,FALSE,151,134,285,3.51
108,Native,28,Male,2.27,FALSE,162,139,301,2.49
619,Hispanic,25,Female,2.39,FALSE,131,133,264,3.1
235,White,26,Trans*,2.32,TRUE,156,135,291,2.88
679,Hispanic,27,Male,2.09,FALSE,140,135,275,3.01
658,White,30,Trans*,3.45,TRUE,151,141,292,2.6
218,Hispanic,28,Male,1.59,TRUE,162,134,296,3.16
298,Black,23,Trans*,3.09,FALSE,157,130,287,2.56
192,Native,23,Female,2.3,TRUE,149,148,297,3.49
679,White,30,Female,2.04,TRUE,155,161,316,3.1
136,White,28,Trans*,2.48,TRUE,147,130,277,3.02
584,White,26,Male,2.29,TRUE,150,134,284,3.41
565,Black,29,Trans*,2.11,FALSE,140,137,277,1.38
669,White,29,Trans*,2.6,TRUE,135,144,279,2.4
312,Hispanic,20,Female,1.69,TRUE,157,133,290,3.31
530,White,27,Male,2.65,TRUE,146,132,278,2.84
597,Hispanic,25,Female,3.21,TRUE,147,133,280,3.29
493,White,25,Male,3.19,FALSE,142,137,279,2.87
716,White,25,Trans*,2.62,TRUE,138,131,269,3.19
418,Hispanic,26,Female,2.9,TRUE,160,146,306,3.44
272,White,20,Female,1.71,FALSE,150,136,286,3.67
703,Hispanic,26,Trans*,1.52,TRUE,148,134,282,3.43
025,White,20,Trans*,3.12,TRUE,148,131,279,2.38
113,White,22,Male,2.55,FALSE,162,136,298,2.67
698,White,29,Male,2.62,TRUE,148,141,289,2.83
702,White,26,Female,3.49,TRUE,139,135,274,3.69
308,Native,30,Trans*,1.92,TRUE,159,136,295,3.85
718,White,28,Male,2.58,TRUE,144,131,275,3.03
639,Black,27,Female,2,FALSE,137,131,268,3.09
379,White,29,Trans*,2.72,FALSE,143,140,283,2.93
035,White,28,Female,3.04,TRUE,163,136,299,2.62
143,White,24,Trans*,2,FALSE,155,138,293,2.26
280,White,25,Female,3.01,TRUE,137,146,283,3.42
260,White,24,Male,3.2,TRUE,139,138,277,3.75
590,White,22,Male,3.3,TRUE,149,139,288,3.43
602,Hispanic,29,Female,1.91,FALSE,132,140,272,3.04
675,Asian,27,Male,2.42,TRUE,157,134,291,3.21
345,White,22,Female,2.32,TRUE,134,137,271,3.95
151,White,30,Male,3.06,TRUE,148,141,289,3.31
244,Hispanic,29,Trans*,1.92,TRUE,138,141,279,2.63
620,Black,27,Trans*,2.34,FALSE,134,132,266,2.34
368,White,30,Male,3.22,TRUE,135,134,269,3.14
473,White,30,Trans*,1.83,TRUE,149,132,281,2.82
753,Native,30,Female,2.29,FALSE,156,131,287,3.44
600,Black,29,Trans*,2.44,FALSE,147,143,290,3.35
317,Hispanic,25,Trans*,2.36,FALSE,149,136,285,2.67
578,White,20,Female,2.45,FALSE,160,132,292,3.94
614,White,23,Male,2.48,TRUE,145,132,277,3.13
549,Bi-Racial,29,Female,2.65,TRUE,134,131,265,2.62
730,Bi-Racial,26,Male,2.44,TRUE,157,132,289,3.64
468,White,24,Trans*,2.3,FALSE,153,136,289,2.89
707,White,23,Male,2.53,TRUE,149,134,283,3.48
008,White,21,Trans*,1.82,TRUE,139,142,281,3.1
334,White,25,Female,3,FALSE,135,141,276,2.96
436,Asian,29,Trans*,2.86,FALSE,138,140,278,2.5
137,Black,28,Male,1.54,TRUE,157,145,302,2.99
421,Hispanic,24,Male,2.06,TRUE,144,150,294,3.78
628,Asian,26,Trans*,1.57,TRUE,142,131,273,3.15
203,White,22,Trans*,2.78,TRUE,146,153,299,3.93
510,Hispanic,23,Female,1.98,TRUE,146,135,281,3.55
097,White,29,Male,2.32,FALSE,157,133,290,3.04
681,White,23,Female,1.6,TRUE,159,141,300,3.01
450,Asian,22,Male,1.96,FALSE,157,137,294,3.02
186,Black,27,Trans*,2.58,FALSE,146,131,277,2.81
769,Hispanic,21,Female,2.75,TRUE,167,135,302,3.62
491,Hispanic,21,Female,2.35,FALSE,149,144,293,2.87
697,White,28,Female,2.04,FALSE,160,131,291,3.34
604,White,30,Female,2.15,TRUE,161,136,297,3.51
545,White,30,Male,2.67,FALSE,158,130,288,2.25
357,White,21,Male,3.03,TRUE,142,146,288,2.93
637,White,29,Male,2.44,TRUE,134,138,272,3.51
259,White,30,Male,2.16,TRUE,143,141,284,3.63
120,Black,26,Female,2.07,FALSE,157,146,303,3.08
544,White,26,Male,1.79,TRUE,157,141,298,3.59
302,Bi-Racial,29,Trans*,1.92,TRUE,132,138,270,3.53
205,White,20,Trans*,2.02,TRUE,145,134,279,3.37
614,White,28,Female,2.65,FALSE,155,141,296,3.68
454,Asian,30,Male,3.11,TRUE,145,131,276,3.18
541,White,25,Male,1.75,FALSE,149,132,281,2.53
716,White,27,Male,2.83,FALSE,143,139,282,3.55
018,White,26,Female,1.91,FALSE,161,138,299,3.06
158,Hawaiian,21,Female,2.37,TRUE,153,141,294,3.69
489,White,20,Female,3.15,FALSE,144,134,278,3.13
208,White,30,Male,2.42,TRUE,164,131,295,3.12
484,White,25,Female,1.88,TRUE,134,131,265,3.87
410,Hispanic,24,Male,3.19,FALSE,131,140,271,2.92
601,White,23,Male,2.93,TRUE,154,137,291,2.99
592,Black,28,Female,3.04,FALSE,158,141,299,3.04
420,Asian,22,Male,1.47,FALSE,142,140,282,2.26
455,Asian,27,Female,2.23,FALSE,144,138,282,2.81
089,White,25,Female,2.06,TRUE,135,132,267,2.37
607,Black,26,Trans*,2.07,TRUE,148,148,296,3.34
101,White,25,Male,2.79,TRUE,144,130,274,3.73
222,Black,23,Trans*,2.5,FALSE,161,144,305,1.82
140,White,20,Male,3.77,FALSE,139,133,272,2.66
466,White,28,Trans*,2.26,FALSE,149,133,282,3.62
557,White,28,Trans*,2.31,FALSE,138,138,276,3.28
371,Asian,27,Male,2.52,FALSE,138,134,272,1.91
632,White,22,Trans*,2.54,FALSE,136,141,277,2.65
488,Asian,22,Trans*,1.95,FALSE,150,137,287,3.29
238,White,20,Male,2.5,TRUE,139,134,273,3.15
340,Hispanic,24,Trans*,3.12,FALSE,140,139,279,2.2
319,White,21,Trans*,1.93,FALSE,148,132,280,3.31
608,White,25,Male,3.59,TRUE,151,136,287,2.96
785,White,26,Trans*,2.81,TRUE,141,163,304,3.76
172,White,24,Trans*,2.06,TRUE,159,131,290,3.43
421,White,28,Female,1.65,FALSE,145,141,286,2.05
781,Asian,24,Male,3.37,TRUE,155,131,286,2.79
501,White,24,Female,2.97,FALSE,133,143,276,3.23
321,White,28,Male,2.42,TRUE,160,132,292,2.61
205,White,30,Trans*,2.69,FALSE,131,130,261,3.15
335,White,24,Female,2.48,FALSE,163,142,305,3.93
775,White,29,Trans*,2.04,TRUE,140,131,271,3.24
265,White,25,Male,2.26,TRUE,137,135,272,3.22
520,Hispanic,22,Trans*,2.26,FALSE,145,136,281,2.98
210,Hispanic,25,Male,3.12,FALSE,143,132,275,3.51
339,Asian,23,Trans*,3.45,FALSE,146,132,278,2.33
160,White,27,Trans*,3.09,FALSE,165,130,295,3.17
140,Black,22,Male,1.41,TRUE,166,137,303,3.06
566,Black,26,Female,2.48,FALSE,143,154,297,3.08
514,White,25,Female,1.58,TRUE,164,151,315,3.34
485,White,29,Female,3.64,FALSE,143,140,283,3.55
020,Hispanic,29,Male,3.19,FALSE,155,132,287,3.54
350,Hispanic,30,Male,3.07,FALSE,138,135,273,3.5
366,White,21,Trans*,2.42,FALSE,143,135,278,2.78
469,White,24,Male,2.67,FALSE,139,146,285,3.39
001,Bi-Racial,23,Trans*,2.5,FALSE,167,132,299,2.92
131,Asian,25,Trans*,2.85,TRUE,160,135,295,3.63
466,White,28,Male,2.24,TRUE,144,134,278,3.7
635,Asian,22,Male,2.63,TRUE,145,132,277,3.82
617,White,30,Trans*,2.05,TRUE,148,143,291,3.39
578,White,30,Male,2.61,TRUE,153,138,291,3.57
496,Hispanic,22,Female,2.63,FALSE,136,145,281,2.39
686,White,20,Male,3.02,TRUE,147,131,278,3.17
625,White,23,Trans*,3.57,FALSE,166,136,302,3.57
542,White,27,Male,3.04,TRUE,157,137,294,3.66
388,Black,27,Female,1.78,FALSE,157,135,292,2.46
060,White,23,Trans*,2.38,FALSE,144,139,283,2.98
580,Black,20,Trans*,2.65,TRUE,159,134,293,3.1
103,White,30,Trans*,3.22,TRUE,164,145,309,3.63
729,White,27,Trans*,2.74,FALSE,141,136,277,3.37
531,White,27,Female,2.22,FALSE,148,147,295,3.54
198,Hispanic,21,Trans*,2.57,TRUE,165,141,306,3.93
207,White,26,Female,3.22,TRUE,135,135,270,2.52
636,Black,30,Trans*,2.59,TRUE,137,136,273,3.94
472,Black,22,Trans*,1.79,FALSE,150,134,284,2.61
452,White,27,Trans*,2.29,FALSE,165,143,308,3.81
646,White,29,Male,3.34,TRUE,144,134,278,2.88
051,White,25,Female,2.2,TRUE,135,134,269,2.76
058,Hispanic,24,Female,2.88,TRUE,139,134,273,3.93
613,White,26,Male,2.57,FALSE,159,143,302,2.04
092,Black,22,Female,2.67,TRUE,165,141,306,2.51
432,White,20,Male,2.6,FALSE,138,141,279,2.96
352,White,24,Trans*,3.68,FALSE,142,138,280,2.65
419,Hispanic,21,Male,2.41,FALSE,137,132,269,3.13
499,White,27,Male,1.86,FALSE,164,131,295,3.04
474,White,21,Trans*,3.25,FALSE,150,144,294,2.75
458,White,22,Male,2.83,TRUE,134,140,274,2.47
704,White,22,Male,2.37,FALSE,167,133,300,3.57
304,White,25,Male,2.32,TRUE,148,135,283,2.68
065,White,21,Trans*,2.66,FALSE,135,141,276,2.39
162,White,28,Trans*,1.75,FALSE,134,135,269,3.23
122,Black,27,Male,1.45,TRUE,155,131,286,3.44
349,Hispanic,25,Female,2.15,FALSE,163,147,310,3.86
010,White,24,Male,2.22,TRUE,155,141,296,3.94
398,White,29,Male,2.59,TRUE,136,136,272,3.24
304,White,23,Female,2.62,FALSE,161,135,296,2.98
446,White,24,Trans*,2.22,TRUE,147,135,282,3.15
628,White,25,Female,2.8,FALSE,144,134,278,2.32
309,White,28,Trans*,2.42,FALSE,157,134,291,2.66
770,White,23,Male,2.71,TRUE,147,131,278,3.42
301,White,26,Male,3.52,TRUE,149,131,280,3.42
147,Black,21,Trans*,2.76,FALSE,161,134,295,2.44
422,Hispanic,27,Trans*,2.96,FALSE,137,130,267,3.03
623,Hispanic,28,Female,3.3,TRUE,135,135,270,3.7
642,White,25,Female,2.6,TRUE,151,134,285,3.43
631,Black,29,Female,1.76,TRUE,133,134,267,3
784,White,24,Trans*,3.27,TRUE,131,134,265,3.87
426,White,25,Male,3.67,FALSE,159,143,302,3.56
391,Hispanic,23,Female,2.51,TRUE,139,137,276,2.93
188,White,22,Trans*,2.84,TRUE,146,144,290,2.98
256,White,26,Female,2.53,FALSE,149,143,292,2.95
096,White,29,Trans*,1.48,TRUE,159,135,294,2.68
757,Hispanic,29,Male,3.07,TRUE,144,134,278,2.53
445,Bi-Racial,24,Trans*,2.33,TRUE,170,144,314,3.31
441,Black,22,Male,2.76,TRUE,145,134,279,3.69
201,Hispanic,30,Female,2.41,TRUE,144,140,284,3.41
759,White,27,Trans*,3.41,TRUE,156,134,290,3.33
146,White,25,Female,2.23,TRUE,147,140,287,3.66
063,White,26,Male,1.22,TRUE,146,136,282,3.39
538,Hispanic,22,Female,1.79,TRUE,158,146,304,3.15
600,White,23,Male,3.02,TRUE,142,131,273,3.92
611,White,28,Female,2.1,TRUE,161,131,292,3.43
561,White,24,Male,1.79,FALSE,153,139,292,3.29
161,White,26,Female,2.51,TRUE,148,144,292,2.61
258,White,29,Male,3.2,FALSE,154,131,285,2.41
185,Asian,20,Male,3.22,TRUE,133,130,263,3.17
102,White,30,Trans*,2.7,FALSE,162,133,295,2.27
599,White,20,Female,2.45,FALSE,161,134,295,1.93
630,White,26,Male,2.41,TRUE,156,135,291,2.83
389,White,22,Trans*,2.87,FALSE,168,138,306,2.46
026,Black,25,Male,1.55,TRUE,156,135,291,2.96
563,White,26,Female,2.36,FALSE,150,141,291,3.1
364,White,20,Male,2.73,TRUE,135,158,293,3.5
411,Hispanic,28,Trans*,2.81,TRUE,138,143,281,2.7
736,Hispanic,29,Male,2.87,FALSE,157,131,288,2.18
360,Hispanic,21,Male,2.28,TRUE,146,135,281,3.6
593,White,26,Trans*,2.73,TRUE,154,131,285,3.61
295,White,22,Trans*,2.77,TRUE,154,132,286,3.88
152,White,22,Trans*,3.33,TRUE,134,133,267,3.38
216,White,22,Female,2.38,FALSE,156,130,286,2.74
654,White,27,Trans*,2.36,TRUE,141,132,273,2.97
294,Asian,30,Trans*,2.96,FALSE,150,135,285,2.67
035,White,21,Male,2.84,FALSE,139,137,276,2.45
682,White,21,Male,2.01,FALSE,167,141,308,2.44
145,White,25,Trans*,2.84,TRUE,151,137,288,3.68
148,White,30,Male,3.09,FALSE,150,133,283,2.56
106,White,25,Male,2.04,TRUE,154,134,288,3.83
103,Black,26,Male,1.92,FALSE,142,134,276,2.4
313,White,23,Female,1.87,FALSE,159,136,295,1.93
573,White,30,Male,2.23,TRUE,137,141,278,3.57
210,Bi-Racial,20,Female,3.27,TRUE,155,130,285,3.6
031,White,23,Female,2.8,TRUE,159,130,289,2.91
291,White,24,Female,2.8,FALSE,152,131,283,3.12
069,White,22,Trans*,3.05,FALSE,148,155,303,2.79
609,Black,24,Male,2.94,FALSE,155,134,289,2.6
555,White,30,Trans*,2.05,FALSE,143,148,291,2.9
705,White,24,Female,2.76,TRUE,147,144,291,3.61
135,Black,21,Trans*,2.04,TRUE,150,139,289,2.54
298,White,20,Female,2.87,TRUE,151,139,290,3.43
154,White,28,Male,2.68,FALSE,146,132,278,2.98
142,White,25,Female,3.15,FALSE,136,134,270,3.33
062,White,26,Female,2.95,FALSE,155,135,290,3.05
765,White,29,Female,2.28,TRUE,146,132,278,3.47
039,Native,21,Male,2.4,TRUE,144,140,284,3.72
117,Asian,20,Male,2.65,TRUE,156,143,299,3.11
789,Hispanic,29,Female,3.16,TRUE,162,133,295,3.05
355,Hawaiian,22,Trans*,2.73,TRUE,157,133,290,3.16
511,White,29,Trans*,1.63,TRUE,134,138,272,3.87
627,Black,26,Female,2.26,FALSE,141,133,274,2.62
003,White,24,Female,3.24,TRUE,136,138,274,3.4
650,Black,26,Female,2.54,TRUE,153,131,284,3.72
448,White,22,Male,2.94,TRUE,157,131,288,3.3
427,White,20,Female,2.24,FALSE,154,134,288,3.44
247,Hispanic,25,Male,2.03,TRUE,138,132,270,3.28
175,White,26,Female,2.12,TRUE,131,138,269,3.36
166,Hispanic,22,Male,2.76,FALSE,135,152,287,2.37
285,Hispanic,24,Male,2.67,TRUE,158,148,306,2.81
079,White,29,Male,2.82,FALSE,144,133,277,3.01
595,White,29,Trans*,2.35,FALSE,142,137,279,3.57
003,Hispanic,25,Trans*,2.53,FALSE,155,130,285,3.27
170,White,25,Trans*,2.42,TRUE,150,139,289,3.5
658,White,24,Male,2.63,FALSE,132,138,270,1.99
544,White,25,Trans*,2.53,FALSE,136,133,269,3.13
652,Hispanic,21,Male,2.84,TRUE,137,133,270,2.52
092,White,23,Male,1.71,FALSE,154,147,301,2.9
684,White,24,Male,2.17,TRUE,144,144,288,2.5
349,Black,21,Female,2.48,TRUE,151,133,284,3.13
492,Black,25,Trans*,2.5,FALSE,154,141,295,3.2
467,White,21,Trans*,2.65,FALSE,150,142,292,3.16
525,White,22,Female,2.47,FALSE,152,133,285,3.13
010,White,29,Male,2.9,FALSE,149,131,280,3.72
179,White,25,Male,2.8,FALSE,144,145,289,3.1
019,Black,27,Female,2.23,FALSE,142,153,295,2.36
363,White,21,Trans*,2.4,TRUE,151,136,287,2.94
292,White,22,Trans*,1.93,TRUE,139,144,283,3.91
067,White,24,Male,2.24,TRUE,143,130,273,3.64
169,Hispanic,25,Male,1.7,FALSE,165,138,303,3.27
545,Hispanic,26,Trans*,2.68,TRUE,165,132,297,3.61
734,White,28,Female,3.31,FALSE,149,135,284,2.73
533,White,26,Female,2.99,TRUE,147,137,284,2.7
569,Hispanic,21,Male,2.21,FALSE,148,133,281,3.67
413,Bi-Racial,30,Female,3.71,FALSE,138,131,269,2.43
547,Black,24,Male,1.46,TRUE,159,149,308,3.89
656,White,23,Trans*,1.8,FALSE,135,130,265,2.71
693,White,22,Trans*,2.35,TRUE,168,147,315,3.25
317,White,23,Female,1.92,TRUE,151,134,285,3.91
546,Black,26,Female,1.77,FALSE,150,131,281,3.57
582,White,22,Female,1.62,TRUE,162,132,294,2.94
761,White,24,Male,2.89,FALSE,145,145,290,3.25
560,Black,23,Female,2.27,TRUE,149,131,280,2.68
713,White,21,Trans*,3.01,FALSE,168,130,298,3.95
437,Hispanic,28,Female,2.41,FALSE,134,141,275,2.86
122,Asian,30,Female,2.96,FALSE,134,144,278,3.45
621,White,24,Female,1.73,FALSE,144,134,278,3.32
146,White,26,Male,2.35,FALSE,156,132,288,1.52
199,Bi-Racial,28,Trans*,1.66,TRUE,165,138,303,3.11
394,Hispanic,30,Male,1.47,FALSE,137,134,271,2.76
376,White,27,Female,3.4,TRUE,143,150,293,3.06
406,White,25,Female,2.3,FALSE,146,139,285,2.24
673,White,29,Female,3.44,FALSE,134,131,265,2.03
748,Hispanic,30,Female,2.69,TRUE,151,153,304,3.03
588,Bi-Racial,23,Male,2.77,TRUE,151,133,284,2.42
440,White,24,Female,2.55,TRUE,161,133,294,3.35
647,White,26,Trans*,2.52,FALSE,149,143,292,2.31
365,White,22,Trans*,2.78,FALSE,134,145,279,2.63
708,Hispanic,27,Female,2.04,TRUE,156,137,293,3.54
015,White,22,Trans*,2.82,FALSE,158,137,295,3.41
076,White,22,Female,2.47,TRUE,152,137,289,3.43
185,White,25,Male,2.41,FALSE,143,138,281,3.61
542,Black,28,Trans*,2.39,FALSE,141,140,281,2.81
144,White,30,Female,2.66,TRUE,147,149,296,3.54
077,White,20,Male,2.56,TRUE,132,138,270,3.76
715,White,25,Female,2.52,FALSE,159,132,291,2.75
352,Hispanic,28,Trans*,2.04,TRUE,170,134,304,3.54
713,Bi-Racial,22,Trans*,2.8,TRUE,138,134,272,2.61
463,White,28,Female,2.32,FALSE,153,139,292,2.77
018,White,30,Male,2.2,TRUE,167,134,301,3.34
522,Hispanic,20,Trans*,2.34,FALSE,142,130,272,2.56
775,Hispanic,23,Female,3.42,FALSE,134,133,267,3.15
683,White,25,Female,2.7,FALSE,140,134,274,2.85
318,White,26,Female,2.69,FALSE,135,131,266,3.23
382,Black,21,Trans*,1.87,FALSE,131,133,264,3.95
054,White,21,Trans*,2.12,TRUE,153,134,287,2.98
405,White,24,Trans*,3.06,TRUE,148,140,288,3.54
550,Black,20,Female,2.08,FALSE,162,136,298,2.8
696,White,27,Trans*,2.77,TRUE,141,148,289,3.42
136,Black,22,Trans*,2.33,FALSE,135,153,288,2.49
360,White,28,Female,2.58,FALSE,144,137,281,2.7
252,White,24,Female,3.29,TRUE,144,133,277,3.29
680,White,23,Male,2.62,FALSE,153,132,285,2.87
316,White,28,Female,2.6,FALSE,155,135,290,2.7
214,Hispanic,30,Female,2.7,TRUE,144,145,289,3.13
548,Hispanic,29,Female,2.51,FALSE,160,136,296,2.34
259,White,26,Female,2.18,FALSE,141,144,285,2.48
500,White,24,Female,2.63,TRUE,132,132,264,2.81
675,Black,26,Female,3.24,FALSE,144,145,289,3.02
420,White,27,Female,2.69,TRUE,151,138,289,3.11
523,White,28,Male,2.63,TRUE,151,130,281,2.85
359,White,25,Trans*,2.76,FALSE,146,130,276,2.62
335,White,21,Male,2.76,TRUE,152,137,289,3.59
740,Black,22,Trans*,2.75,FALSE,155,136,291,2.43
276,White,27,Trans*,3.1,TRUE,161,137,298,3.45
041,White,27,Male,2.92,TRUE,148,135,283,2.89
636,White,20,Male,1.81,FALSE,142,138,280,2.83
763,White,23,Female,2.28,FALSE,158,130,288,3.35
168,White,24,Male,2.01,TRUE,141,150,291,3.76
105,Black,24,Female,3.28,FALSE,131,131,262,2.94
506,Black,27,Female,2.45,TRUE,158,135,293,3.26
595,White,23,Male,1.53,TRUE,134,130,264,3.53
519,Asian,25,Trans*,3.43,FALSE,153,131,284,3.47
504,White,27,Female,1.9,TRUE,161,144,305,2.97
014,White,22,Female,2.23,FALSE,148,133,281,2.54
791,Hispanic,26,Male,2.18,TRUE,149,132,281,3.83
134,White,30,Female,2.16,FALSE,147,136,283,2.66
519,Hispanic,25,Trans*,1.86,TRUE,159,139,298,2.94
732,White,23,Male,2.31,FALSE,158,134,292,3.04
123,White,24,Trans*,2.68,FALSE,152,132,284,3.11
289,Hispanic,22,Male,2.29,FALSE,140,134,274,3.58
299,White,29,Female,2.37,TRUE,155,133,288,3.68
730,White,24,Trans*,2.56,FALSE,149,131,280,3
163,White,29,Trans*,3.73,FALSE,150,131,281,2.45
760,White,29,Trans*,2.31,FALSE,137,149,286,1.92
156,Hispanic,21,Trans*,2.6,FALSE,149,134,283,3.63
518,White,24,Male,2.36,FALSE,155,136,291,2.1
686,Hispanic,24,Female,2.79,FALSE,167,143,310,3.58
174,White,24,Trans*,1.92,TRUE,152,131,283,3.55
004,White,21,Trans*,2.78,TRUE,137,134,271,2.56
034,White,30,Male,2.04,TRUE,137,137,274,3.47
033,White,24,Female,2.37,TRUE,164,139,303,2.88
772,White,28,Trans*,2.53,FALSE,140,131,271,2.4
663,Black,26,Male,3.22,TRUE,161,134,295,2.5
409,White,26,Male,1.72,FALSE,159,136,295,2.65
370,White,27,Male,2.22,FALSE,142,146,288,2.99
768,White,27,Female,2.33,FALSE,154,133,287,3.07
069,White,27,Trans*,2.06,TRUE,168,144,312,3.83
603,White,30,Trans*,3.03,TRUE,133,134,267,3.28
386,White,29,Male,2.99,FALSE,148,134,282,2.36
061,Hispanic,29,Female,2,FALSE,159,131,290,1.75
285,White,27,Female,1.93,FALSE,154,141,295,2.86
055,White,22,Trans*,2.19,TRUE,141,139,280,2.3
596,White,26,Female,2.56,FALSE,159,144,303,2.1
222,White,28,Trans*,2.26,TRUE,155,131,286,3.91
477,White,24,Male,3.59,TRUE,148,133,281,3.71
181,Hispanic,29,Trans*,2.73,FALSE,167,135,302,3.59
024,Hispanic,23,Female,2.04,FALSE,158,141,299,2.9
586,White,25,Trans*,1.5,TRUE,135,137,272,3.23
464,White,20,Male,2.66,TRUE,148,152,300,3.65
159,White,27,Male,2.47,TRUE,147,145,292,3.67
211,White,30,Male,2.56,FALSE,151,131,282,2.74
150,White,24,Male,2,FALSE,143,135,278,2.73
053,Hispanic,27,Male,2,TRUE,158,132,290,2.91
618,Hispanic,20,Female,2.55,TRUE,150,136,286,2.91
088,White,22,Female,2.32,TRUE,142,148,290,2.82
475,White,22,Male,2.2,TRUE,153,137,290,3.23
252,White,25,Female,2.05,FALSE,133,138,271,2.96
315,White,30,Male,2.14,TRUE,155,141,296,3.77
597,White,25,Trans*,2.76,FALSE,162,145,307,3.02
487,Black,25,Male,2.22,FALSE,164,132,296,2.12
162,White,20,Male,2.62,TRUE,133,135,268,3.82
471,White,24,Female,2.06,TRUE,158,152,310,3.13
279,White,26,Trans*,2.97,TRUE,156,137,293,3.67
394,Hispanic,20,Female,2.82,TRUE,152,131,283,3.53
013,White,30,Trans*,2.73,TRUE,149,143,292,3.74
762,Hispanic,23,Female,2.69,TRUE,141,136,277,3.15
526,Black,28,Male,2.24,TRUE,142,135,277,3.63
570,Bi-Racial,28,Female,2.15,FALSE,138,132,270,2.73
449,White,29,Male,2.58,FALSE,150,140,290,3.3
671,Hispanic,20,Trans*,2.42,FALSE,134,137,271,2.4
783,Black,28,Male,1.95,FALSE,164,137,301,2.79
055,White,23,Female,1.83,FALSE,144,136,280,3.31
594,White,29,Male,2.42,TRUE,146,146,292,3.95
228,Hispanic,27,Female,2.48,FALSE,141,145,286,1.99
180,Hispanic,27,Female,2.14,FALSE,152,132,284,3.19
564,Black,27,Trans*,2.58,FALSE,168,133,301,3.06
615,Asian,24,Trans*,1.25,TRUE,156,130,286,3.17
408,White,26,Trans*,2.57,FALSE,152,132,284,3.43
719,White,24,Female,1.98,FALSE,145,135,280,2.83
787,Black,24,Trans*,2.02,TRUE,163,132,295,2.58
450,White,29,Trans*,2.28,TRUE,147,134,281,3.49
044,White,25,Female,2.51,TRUE,139,130,269,3.35
552,Bi-Racial,20,Trans*,3.05,FALSE,145,131,276,2.96
470,White,25,Female,2.29,TRUE,138,133,271,3.72
291,Hispanic,25,Female,2.72,TRUE,143,140,283,2.99
479,Hispanic,22,Male,1.97,TRUE,153,142,295,3.45
344,Bi-Racial,27,Male,2.3,TRUE,148,146,294,3.81
281,Hispanic,21,Trans*,2.8,FALSE,132,140,272,2.87
688,White,23,Female,2.71,FALSE,144,150,294,2.39
368,White,28,Female,2.35,FALSE,132,130,262,2.38
057,Black,28,Female,2.16,FALSE,145,133,278,3.54
028,Black,21,Male,2.88,TRUE,140,130,270,2.53
717,White,21,Female,1.92,FALSE,159,131,290,3.26
579,Bi-Racial,23,Female,2.6,FALSE,164,136,300,3.77
399,White,23,Male,2.66,FALSE,142,133,275,2.89
165,Black,28,Trans*,2.49,FALSE,144,132,276,3.24
366,Bi-Racial,26,Male,1.92,TRUE,135,134,269,3.05
441,White,27,Male,2.47,FALSE,158,137,295,2.83
282,White,24,Female,2.59,FALSE,166,139,305,2.45
428,White,28,Male,2.65,TRUE,140,132,272,3.35
113,Asian,24,Male,2.89,TRUE,130,144,274,3.59
227,Black,30,Male,1.79,TRUE,143,148,291,3.61
070,Hispanic,21,Female,2.78,FALSE,146,142,288,2.91
341,Asian,29,Female,3.74,TRUE,155,137,292,3.23
385,Hispanic,26,Female,2.35,FALSE,152,139,291,2.45
238,Black,22,Female,2.67,FALSE,145,137,282,2.88
012,White,20,Female,2.48,FALSE,139,147,286,2.83
478,White,29,Trans*,2.69,TRUE,137,134,271,3.49
314,White,24,Trans*,2.71,TRUE,154,138,292,3.04
224,White,30,Trans*,2.71,TRUE,166,134,300,3.19
215,Hispanic,30,Female,2.8,FALSE,152,135,287,3.15
721,Black,26,Male,2.67,TRUE,139,136,275,3.2
250,Hispanic,22,Female,2.3,FALSE,147,141,288,2.93
063,White,22,Female,2.86,FALSE,139,131,270,3.48
576,White,25,Female,2.8,TRUE,152,148,300,2.79
164,White,28,Male,2.24,FALSE,150,131,281,2.59
160,White,28,Male,1.51,TRUE,158,135,293,3.06
299,White,30,Trans*,3.19,FALSE,133,135,268,2.51
508,Black,22,Male,3.1,TRUE,164,142,306,2.99
416,Hispanic,22,Male,2.75,FALSE,153,148,301,3.38
699,White,30,Male,2.64,TRUE,142,144,286,3.62
081,Hispanic,21,Trans*,1.6,FALSE,169,149,318,2.68
649,White,23,Female,3.99,FALSE,139,138,277,2.87
566,Black,27,Female,2.47,TRUE,140,138,278,3.46
293,Asian,27,Male,3.01,TRUE,148,135,283,2.92
045,White,27,Trans*,2.63,TRUE,142,131,273,3.33
517,Hispanic,26,Trans*,2.06,FALSE,151,136,287,3.74
422,Black,28,Trans*,2.4,TRUE,137,147,284,3.2
287,White,25,Trans*,2.74,TRUE,162,131,293,3.69
641,White,25,Female,1.98,TRUE,135,134,269,3.44
574,White,23,Male,2.22,FALSE,144,140,284,3.08
725,Asian,29,Trans*,2.82,FALSE,151,138,289,2.52
275,White,25,Male,2.51,FALSE,151,142,293,2.27
570,White,30,Trans*,2.39,TRUE,163,143,306,3.73
203,White,28,Male,1.8,FALSE,158,133,291,2.76
234,Black,25,Female,1.53,TRUE,152,130,282,3.26
480,White,27,Female,1.82,FALSE,159,141,300,2.63
697,White,27,Trans*,2.21,TRUE,149,144,293,3.53
163,White,25,Male,2.02,TRUE,152,131,283,3.26
553,Hispanic,20,Trans*,2.89,TRUE,152,133,285,3.24
071,White,29,Male,1.45,TRUE,143,131,274,3.18
447,White,30,Trans*,2.29,FALSE,150,130,280,2.86
395,White,22,Male,1.86,TRUE,136,139,275,3.77
388,White,24,Male,3.35,TRUE,145,139,284,2.8
567,White,29,Female,3.07,FALSE,138,142,280,2.91
156,Bi-Racial,21,Female,2.44,TRUE,146,142,288,3.85
571,White,25,Trans*,2.97,TRUE,160,137,297,3.49
384,White,30,Trans*,3,TRUE,133,146,279,3.16
261,Black,21,Trans*,2.77,TRUE,147,140,287,3.58
229,White,22,Female,2.37,TRUE,134,136,270,2.45
329,White,23,Male,2.55,FALSE,138,136,274,2.5
309,White,30,Female,2.56,TRUE,141,141,282,2.93
253,White,23,Trans*,3.38,TRUE,157,146,303,3.2
200,Hispanic,27,Male,2.24,TRUE,165,134,299,2.45
497,White,22,Female,2.83,FALSE,135,137,272,3.57
196,Black,20,Trans*,1.49,TRUE,150,138,288,3.6
507,Hispanic,27,Female,2.44,TRUE,134,138,272,3.2
521,Asian,27,Male,2.47,FALSE,142,134,276,2.02
333,White,23,Male,1.9,FALSE,169,131,300,2.95
719,Bi-Racial,24,Female,3.23,TRUE,156,155,311,3.4
138,Black,30,Trans*,2.01,FALSE,135,133,268,2.73
728,White,27,Male,2.53,FALSE,131,142,273,2.63
104,Black,24,Male,2.74,FALSE,154,133,287,3.32
651,White,30,Female,1.78,FALSE,155,135,290,2.18
700,Asian,26,Male,2.44,FALSE,140,134,274,3.76
770,White,21,Male,1.34,FALSE,135,136,271,3.23
261,White,24,Trans*,1.09,FALSE,151,130,281,2.62
134,White,22,Trans*,2.87,TRUE,165,148,313,3.65
434,Hispanic,22,Trans*,3.26,FALSE,147,150,297,3.47
694,Native,25,Trans*,2.6,FALSE,137,137,274,2.92
152,White,25,Female,2.49,FALSE,146,132,278,2.62
036,White,24,Male,3.13,FALSE,149,143,292,2.28
100,Hispanic,22,Trans*,3.11,TRUE,146,134,280,3.41
727,White,23,Female,3.11,TRUE,152,139,291,2.71
265,Black,20,Trans*,2.84,FALSE,130,135,265,2.06
523,White,24,Trans*,2.22,FALSE,157,149,306,2.18
206,Hispanic,27,Trans*,2.28,TRUE,132,138,270,3.54
516,Hispanic,20,Male,2,TRUE,153,138,291,3.1
154,Black,21,Male,2.95,TRUE,148,131,279,3.21
093,White,25,Male,2.98,TRUE,160,130,290,3.14
212,White,27,Female,2.78,TRUE,159,135,294,3.39
780,White,30,Male,2.35,TRUE,170,134,304,3.65
738,White,24,Trans*,2.38,FALSE,164,137,301,3.4
592,Black,22,Trans*,3.64,TRUE,139,139,278,3.14
167,White,20,Trans*,2.79,FALSE,142,134,276,3.86
204,Hispanic,28,Trans*,1.71,TRUE,152,143,295,3.64
423,White,21,Male,2.76,FALSE,142,142,284,3.13
198,White,25,Female,2.66,FALSE,151,134,285,3.4
241,White,25,Trans*,2.95,TRUE,139,133,272,3.41
721,Black,28,Female,3.02,FALSE,159,139,298,2.58
436,Hispanic,23,Female,2.98,TRUE,157,131,288,2.72
667,Hispanic,25,Trans*,2.29,FALSE,142,135,277,2.14
638,Hispanic,26,Trans*,1.52,FALSE,163,141,304,3.15
348,White,25,Trans*,1.93,FALSE,155,134,289,3.33
575,White,25,Trans*,1.95,TRUE,147,132,279,3.49
535,White,26,Male,2.21,TRUE,152,142,294,2.63
286,White,27,Female,2.82,FALSE,153,138,291,2.91
007,White,29,Female,2.99,FALSE,132,131,263,2.52
554,White,24,Female,1.86,TRUE,148,134,282,3.85
144,Hispanic,22,Male,2.94,FALSE,130,145,275,2.66
408,White,21,Female,2.42,TRUE,132,132,264,3.01
255,White,21,Trans*,1.97,FALSE,144,132,276,3.63
706,White,24,Male,2.59,FALSE,139,132,271,3.08
280,Hispanic,22,Trans*,1.79,FALSE,144,137,281,3.27
650,White,22,Male,3.25,FALSE,147,139,286,3.42
048,White,24,Male,2.52,FALSE,139,142,281,3.47
231,White,28,Trans*,2.68,FALSE,157,161,318,3.34
670,White,24,Trans*,3.22,FALSE,133,131,264,3.76
316,White,28,Male,2.2,TRUE,163,131,294,3.25
288,White,22,Male,2.31,FALSE,142,135,277,2.74
734,White,27,Male,2.47,TRUE,151,132,283,3.32
230,White,27,Female,2.13,FALSE,151,138,289,2.89
459,Hispanic,30,Female,2.97,FALSE,144,140,284,2.75
598,White,25,Male,2.71,FALSE,132,141,273,3.32
653,Black,22,Female,1.77,TRUE,156,133,289,2.96
130,White,29,Male,1.25,FALSE,136,135,271,2.18
293,Hispanic,22,Male,2.76,FALSE,153,134,287,3.87
303,White,26,Trans*,1.58,FALSE,131,133,264,2.15
107,White,30,Male,2.38,TRUE,136,133,269,3
768,White,24,Male,1.96,TRUE,155,142,297,3.63
496,White,29,Male,2.67,TRUE,142,130,272,3.63
068,Black,21,Female,2.48,FALSE,154,141,295,2.44
177,White,20,Trans*,3.11,TRUE,144,137,281,3.93
465,Hispanic,30,Male,3.01,FALSE,131,136,267,3.1
344,White,27,Trans*,2.38,FALSE,154,133,287,2.55
167,White,26,Male,2.85,TRUE,153,138,291,2.99
672,White,21,Female,2.47,FALSE,151,155,306,3.3
038,White,20,Male,2.53,FALSE,137,136,273,2.96
514,White,23,Male,1.97,FALSE,152,137,289,3.54
507,Hispanic,25,Female,3.5,FALSE,159,146,305,2.37
311,Hispanic,22,Trans*,2.86,FALSE,134,142,276,2.33
331,Hispanic,24,Female,3.33,TRUE,157,131,288,2.56
547,White,28,Female,1.87,FALSE,163,142,305,2.28
546,White,30,Trans*,2.69,TRUE,130,139,269,2.52
671,White,24,Trans*,3.12,TRUE,131,136,267,2.91
327,White,21,Male,1.58,TRUE,147,141,288,3.57
219,White,25,Male,2.54,FALSE,135,137,272,2.76
328,White,23,Male,2.66,FALSE,164,139,303,1.76
095,White,24,Male,2.1,TRUE,150,134,284,3.11
482,White,22,Male,2.66,TRUE,135,131,266,3.3
